key	value
GAME_LOADING	Cargando...
EXP_COUNTER_MAX	MAX
COMBAT_ELEMENT_NORMAL_NAME	Normal
MAIN_MENU_BUTTON_SINGLEPLAY	Un jugador
MAIN_MENU_BUTTON_SINGLEPLAY_TOOLTIP	Empezar una partida en modo un jugador
MAIN_MENU_BUTTON_MULTIPLAY	Multijugador
MAIN_MENU_BUTTON_MULTIPLAY_TOOLTIP	Empezar una partida en linea
MAIN_MENU_BUTTON_MULTIPLAY_DISABLED_TOOLTIP	El modo multijugador esta desactivado en la demo
MAIN_MENU_BUTTON_SETTINGS	Ajustes
MAIN_MENU_BUTTON_SETTINGS_TOOLTIP	Configurar Ajustes del juego
MAIN_MENU_BUTTON_QUIT	Salir
MAIN_MENU_BUTTON_QUIT_TOOLTIP	Finalizar aplicacion.
CHARACTER_SELECT_HEADER	Selec Personaje
CHARACTER_SELECT_HEADER_GAME_MODE_SINGLEPLAYER	Un jugador
CHARACTER_SELECT_HEADER_GAME_MODE_HOST_MULTIPLAYER_PUBLIC	Alojar Partida (Publica)
CHARACTER_SELECT_HEADER_GAME_MODE_HOST_MULTIPLAYER_FRIENDS	Alojar Partida (Con Amigos)
CHARACTER_SELECT_HEADER_GAME_MODE_HOST_MULTIPLAYER_PRIVATE	Alojar Partida (Privada)
CHARACTER_SELECT_HEADER_GAME_MODE_JOIN_MULTIPLAYER	Unirse A la Partida
CHARACTER_SELECT_HEADER_GAME_MODE_LOBBY_QUERY	Lobby Query
CHARACTER_SELECT_BUTTON_CREATE_CHARACTER	Crear Personaje
CHARACTER_SELECT_BUTTON_DELETE_CHARACTER	Eliminar Personaje
CHARACTER_SELECT_BUTTON_SELECT_CHARACTER	Selec Personaje
CHARACTER_SELECT_BUTTON_RETURN	Regresar
CHARACTER_SELECT_DATA_ENTRY_EMPTY_SLOT	Espacio Vacio
FORMAT_CHARACTER_SELECT_DATA_ENTRY_INFO	Nv-{0} {1} {2}
CHARACTER_SELECT_CHARACTER_DELETE_PROMPT_TEXT	Escribe el Nombre del personaje para confirmar
CHARACTER_SELECT_CHARACTER_DELETE_PROMPT_PLACEHOLDER_TEXT	Escribe el Nombre..
CHARACTER_SELECT_CHARACTER_DELETE_BUTTON_CONFIRM	Eliminar Personaje
CHARACTER_SELECT_CHARACTER_DELETE_BUTTON_RETURN	Regresar
CHARACTER_CREATION_HEADER	Creacion de Personaje
CHARACTER_CREATION_HEADER_RACE_NAME	Seleccionar Raza
CHARACTER_CREATION_RACE_DESCRIPTOR_HEADER_INITIAL_SKILL	Habilidad Inicial
CHARACTER_CREATION_BUTTON_SET_TO_DEFAULTS	Restablecer
CHARACTER_CREATION_CHARACTER_NAME_PLACEHOLDER_TEXT	Escribe Su Nombre...
CHARACTER_CREATION_BUTTON_CREATE_CHARACTER	Crear Personaje
CHARACTER_CREATION_BUTTON_RETURN	Regresar
CHARACTER_CREATION_CUSTOMIZER_HEADER_COLOR	Color
CHARACTER_CREATION_CUSTOMIZER_COLOR_BODY_HEADER	Cuerpo
CHARACTER_CREATION_CUSTOMIZER_COLOR_BODY_TEXTURE	Textura
CHARACTER_CREATION_CUSTOMIZER_COLOR_HAIR_HEADER	Cabello
CHARACTER_CREATION_CUSTOMIZER_COLOR_HAIR_LOCK_COLOR	bloquear Color
CHARACTER_CREATION_CUSTOMIZER_HEADER_HEAD	Cabeza
CHARACTER_CREATION_CUSTOMIZER_HEAD_HEAD_WIDTH	Ancho de la Cabeza
CHARACTER_CREATION_CUSTOMIZER_HEAD_HEAD_MOD	Modificador
CHARACTER_CREATION_CUSTOMIZER_HEAD_VOICE_PITCH	Tono de Voz
CHARACTER_CREATION_CUSTOMIZER_HEAD_HAIR_STYLE	Cabello
CHARACTER_CREATION_CUSTOMIZER_HEAD_EARS	Orejas
CHARACTER_CREATION_CUSTOMIZER_HEAD_EYES	Ojos
CHARACTER_CREATION_CUSTOMIZER_HEAD_MOUTH	Boca
CHARACTER_CREATION_CUSTOMIZER_HEADER_BODY	Cuerpo
CHARACTER_CREATION_CUSTOMIZER_BODY_HEIGHT	Altura
CHARACTER_CREATION_CUSTOMIZER_BODY_WIDTH	Anchura
CHARACTER_CREATION_CUSTOMIZER_BODY_CHEST	Pecho
CHARACTER_CREATION_CUSTOMIZER_BODY_ARMS	Brazos
CHARACTER_CREATION_CUSTOMIZER_BODY_BELLY	Panza
CHARACTER_CREATION_CUSTOMIZER_BODY_BOTTOM	Tracero
CHARACTER_CREATION_CUSTOMIZER_BODY_TAIL	Cola
CHARACTER_CREATION_CUSTOMIZER_BODY_TOGGLE_LEFT_HANDED	Invertir Cuerpo
CHARACTER_CREATION_CUSTOMIZER_HEADER_TRAIT	Rasgos
CHARACTER_CREATION_CUSTOMIZER_TRAIT_EQUIPMENT	Equipamiento
CHARACTER_CREATION_CUSTOMIZER_TRAIT_WEAPON_LOADOUT	Arma
CHARACTER_CREATION_CUSTOMIZER_TRAIT_GEAR_DYE	Tinte
CHARACTER_CREATION_CUSTOMIZER_TRAIT_ATTRIBUTES	Atributos
CHARACTER_CREATION_CUSTOMIZER_TRAIT_RESET_ATTRIBUTE_POINTS	Reiniciar Puntos
SETTINGS_TAB_BUTTON_VIDEO	Graficos
SETTINGS_TAB_BUTTON_AUDIO	Audio
SETTINGS_TAB_BUTTON_INPUT	Controles
SETTINGS_TAB_BUTTON_NETWORK	Interfaz
SETTINGS_VIDEO_HEADER_GAME_EFFECT_SETTINGS	Ajustes de Contenido Sensible
SETTINGS_VIDEO_CELL_PROPORTIONS_TOGGLE	Limitar Proporciones de los Personajes
SETTINGS_VIDEO_CELL_JIGGLE_BONES_TOGGLE	Desactivar Fisicas Sugestivas
SETTINGS_VIDEO_CELL_CLEAR_UNDERCLOTHES_TOGGLE	Desactivar Ropa Interior
SETTINGS_VIDEO_HEADER_VIDEO_SETTINGS	Ajustes de video
SETTINGS_VIDEO_CELL_FULLSCREEN_TOGGLE	Pantalla Completa
SETTINGS_VIDEO_CELL_VERTICAL_SYNC	Sincronizacion Vertical / Limitar a 60 FPS
SETTINGS_VIDEO_CELL_ANISOTROPIC_FILTERING	Filtro Anisotropico
SETTINGS_VIDEO_CELL_SCREEN_RESOLUTION	Resolucion de pantalla
SETTINGS_VIDEO_CELL_ANTI_ALIASING	Suavizado de imagen
SETTINGS_VIDEO_CELL_ANTI_ALIASING_OPTION_1	Desactivado
SETTINGS_VIDEO_CELL_ANTI_ALIASING_OPTION_2	2x Multi Sampling
SETTINGS_VIDEO_CELL_ANTI_ALIASING_OPTION_3	4x Multi Sampling
SETTINGS_VIDEO_CELL_ANTI_ALIASING_OPTION_4	8x Multi Sampling
SETTINGS_VIDEO_CELL_TEXTURE_FILTERING	Filtrado de texturas
SETTINGS_VIDEO_CELL_TEXTURE_FILTERING_OPTION_1	Bilnear (Suave)
SETTINGS_VIDEO_CELL_TEXTURE_FILTERING_OPTION_2	Cercano (Pixeliado)
SETTINGS_VIDEO_CELL_TEXTURE_QUALITY	Calidad de Texturas
SETTINGS_VIDEO_CELL_TEXTURE_QUALITY_OPTION_1	Alto
SETTINGS_VIDEO_CELL_TEXTURE_QUALITY_OPTION_2	Medio
SETTINGS_VIDEO_CELL_TEXTURE_QUALITY_OPTION_3	Bajo
SETTINGS_VIDEO_CELL_TEXTURE_QUALITY_OPTION_4	Muy Bajo
SETTINGS_VIDEO_HEADER_CAMERA_SETTINGS	Ajustes de Camara
SETTINGS_VIDEO_CELL_FIELD_OF_VIEW	Campo de vision
SETTINGS_VIDEO_CELL_CAMERA_SMOOTHING	Suavizado de camara
SETTINGS_VIDEO_CELL_CAMERA_HORIZ	Posicion de camara X
SETTINGS_VIDEO_CELL_CAMERA_VERT	Posicion de camara Y
SETTINGS_VIDEO_CELL_CAMERA_RENDER_DISTANCE	Distancia de vision
SETTINGS_VIDEO_CELL_CAMERA_RENDER_DISTANCE_OPTION_1	Muy Cercana
SETTINGS_VIDEO_CELL_CAMERA_RENDER_DISTANCE_OPTION_2	Cercana
SETTINGS_VIDEO_CELL_CAMERA_RENDER_DISTANCE_OPTION_3	Lejana
SETTINGS_VIDEO_CELL_CAMERA_RENDER_DISTANCE_OPTION_4	Muy Lejana
SETTINGS_VIDEO_HEADER_POST_PROCESSING	Post Procesado
SETTINGS_VIDEO_CELL_CAMERA_BITCRUSH_SHADER	Activar Efecto de imagen Retro
SETTINGS_VIDEO_CELL_CAMERA_WATER_EFFECT	Activar Distorsion bajo el agua
SETTINGS_VIDEO_CELL_CAMERA_SHAKE	Activar Efecto de Temblor
SETTINGS_VIDEO_CELL_WEAPON_GLOW	Desactivar efecto de resplandor en las armas
SETTINGS_AUDIO_HEADER_AUDIO_SETTINGS	Ajustes de Sonido
SETTINGS_AUDIO_CELL_MASTER_VOLUME	Volumen General
SETTINGS_AUDIO_CELL_MUTE_APPLICATION	Silenciar Aplicacion
SETTINGS_AUDIO_CELL_MUTE_MUSIC	Silenciar Musica
SETTINGS_AUDIO_HEADER_AUDIO_CHANNEL_SETTINGS	Canales de audio
SETTINGS_AUDIO_CELL_GAME_VOLUME	Volumen del juego
SETTINGS_AUDIO_CELL_GUI_VOLUME	Volumen de la interfaz
SETTINGS_AUDIO_CELL_AMBIENCE_VOLUME	Volumen de Ambiente
SETTINGS_AUDIO_CELL_MUSIC_VOLUME	Volumen de la musica
SETTINGS_AUDIO_CELL_VOICE_VOLUME	Volumen de las voces
SETTINGS_INPUT_HEADER_INPUT_SETTINGS	Ajuste de controles
SETTINGS_INPUT_CELL_AXIS_TYPE	Tipo de control de movimiento
SETTINGS_INPUT_CELL_AXIS_TYPE_OPTION_1	Teclado WASD (8 Direcciones)
SETTINGS_INPUT_CELL_AXIS_TYPE_OPTION_2	Control de Xbox
SETTINGS_INPUT_CELL_AXIS_TYPE_OPTION_3	Control de Playstation 4
SETTINGS_INPUT_HEADER_CAMERA_CONTROL	Control de Camara
SETTINGS_INPUT_CELL_CAMERA_SENSITIVITY	Sensibilidad
SETTINGS_INPUT_CELL_INVERT_X_CAMERA_AXIS	Invertir Horizontalmente
SETTINGS_INPUT_CELL_INVERT_Y_CAMERA_AXIS	Invertir Verticalmente
SETTINGS_INPUT_CELL_KEYBINDING_RESET_CAMERA	Restablecer Camara
SETTINGS_INPUT_HEADER_MOVEMENT	Movimiento
SETTINGS_INPUT_CELL_KEYBINDING_UP	Arriba
SETTINGS_INPUT_CELL_KEYBINDING_DOWN	Abajo
SETTINGS_INPUT_CELL_KEYBINDING_LEFT	Izquierda
SETTINGS_INPUT_CELL_KEYBINDING_RIGHT	Derecha
SETTINGS_INPUT_CELL_KEYBINDING_JUMP	Saltar
SETTINGS_INPUT_CELL_KEYBINDING_DASH	Deslizarse
SETTINGS_INPUT_HEADER_STRAFING	Desplazarmiento
SETTINGS_INPUT_CELL_KEYBINDING_LOCK_DIRECTION	Desplazarse
SETTINGS_INPUT_CELL_KEYBINDING_STRAFE_MODE	Desplazarse / Apuntar
SETTINGS_INPUT_CELL_KEYBINDING_STRAFE_MODE_OPTION_1	Mantener Tecla de Desplazarmiento
SETTINGS_INPUT_CELL_KEYBINDING_STRAFE_MODE_OPTION_2	Alternar tecla de Desplazarmiento
SETTINGS_INPUT_CELL_KEYBINDING_STRAFE_WEAPON	Desplazarse mientras sostienes armas
SETTINGS_INPUT_CELL_KEYBINDING_STRAFE_CASTING	Desplazarse mientras activas habilidades ofensivas
SETTINGS_INPUT_HEADER_ACTION	Accion
SETTINGS_INPUT_CELL_KEYBINDING_ATTACK	Atacar
SETTINGS_INPUT_CELL_KEYBINDING_CHARGE_ATTACK	Cargar ataque
SETTINGS_INPUT_CELL_KEYBINDING_BLOCK	bloquear
SETTINGS_INPUT_CELL_KEYBINDING_TARGET	Fijar Objectivo
SETTINGS_INPUT_CELL_KEYBINDING_INTERACT	Interactuar
SETTINGS_INPUT_CELL_KEYBINDING_PVP_FLAG	Activar bandera PvP
SETTINGS_INPUT_CELL_KEYBINDING_SKILL_SLOT_01	Ranura de Habilidad 1
SETTINGS_INPUT_CELL_KEYBINDING_SKILL_SLOT_02	Ranura de Habilidad 2
SETTINGS_INPUT_CELL_KEYBINDING_SKILL_SLOT_03	Ranura de Habilidad 3
SETTINGS_INPUT_CELL_KEYBINDING_SKILL_SLOT_04	Ranura de Habilidad 4
SETTINGS_INPUT_CELL_KEYBINDING_SKILL_SLOT_05	Ranura de Habilidad 5
SETTINGS_INPUT_CELL_KEYBINDING_SKILL_SLOT_06	Ranura de Habilidad 6
SETTINGS_INPUT_CELL_KEYBINDING_RECALL	Retirarse
SETTINGS_INPUT_CELL_KEYBINDING_QUICKSWAP_WEAPON	Cambio rapido de arma
SETTINGS_INPUT_CELL_KEYBINDING_SHEATHE_WEAPON	Enfundar / Desenfundar Arma
SETTINGS_INPUT_CELL_KEYBINDING_SIT	Sentarse
SETTINGS_INPUT_HEADER_CONSUMABLE_SLOTS	Ranura rapida de consumibles
SETTINGS_INPUT_CELL_KEYBINDING_QUICK_SLOT_01	Ranura rapida 1
SETTINGS_INPUT_CELL_KEYBINDING_QUICK_SLOT_02	Ranura rapida 2
SETTINGS_INPUT_CELL_KEYBINDING_QUICK_SLOT_03	Ranura rapida 3
SETTINGS_INPUT_CELL_KEYBINDING_QUICK_SLOT_04	Ranura rapida 4
SETTINGS_INPUT_CELL_KEYBINDING_QUICK_SLOT_05	Ranura rapida 5
SETTINGS_INPUT_HEADER_INTERFACE	Interfaz
SETTINGS_INPUT_CELL_KEYBINDING_HOST_CONSOLE	Abrir Consola
SETTINGS_INPUT_CELL_KEYBINDING_LEXICON	Abrir Codice
SETTINGS_INPUT_CELL_KEYBINDING_TAB_MENU	Abrir Pestaña del menu
SETTINGS_INPUT_CELL_KEYBINDING_STATS_TAB	Pestaña de estadisticas
SETTINGS_INPUT_CELL_KEYBINDING_SKILLS_TAB	Pestaña de Habilidades
SETTINGS_INPUT_CELL_KEYBINDING_ITEM_TAB	Pestaña de inventario
SETTINGS_INPUT_CELL_KEYBINDING_QUEST_TAB	Pestaña de Misiones
SETTINGS_INPUT_CELL_KEYBINDING_WHO_TAB	Pestaña de ayuda
SETTINGS_INPUT_CELL_KEYBINDING_HIDE_UI	Ocultar Interfaz
SETTINGS_NETWORK_HEADER_UI_SETTINGS	Ajustes de interfaz
SETTINGS_NETWORK_CELL_LOCALYSSATION_LANGUAGE	Idioma
SETTINGS_NETWORK_CELL_DISPLAY_CREEP_NAMETAGS	Mostrar Nombres de los enemigos
SETTINGS_NETWORK_CELL_DISPLAY_GLOBAL_NICKNAME_TAGS	Mostrar Nombres Globales <color=cyan>(@XX)</color>
SETTINGS_NETWORK_CELL_DISPLAY_LOCAL_NAMETAG	Mostrar Nombre local del personaje
SETTINGS_NETWORK_CELL_DISPLAY_HOST_TAG	Mostrar etiqueta [HOST] en el personaje del Administrador
SETTINGS_NETWORK_CELL_HIDE_DUNGEON_MINIMAP	Ocultar minimapa de la mazmorra
SETTINGS_NETWORK_CELL_HIDE_FPS_COUNTER	Ocultar Contador de FPS
SETTINGS_NETWORK_CELL_HIDE_PING_COUNTER	Ocultar Contador de Ping
SETTINGS_NETWORK_CELL_HIDE_STAT_POINT_COUNTER	Ocultar Notificacion de Puntos de estadisticas
SETTINGS_NETWORK_CELL_HIDE_SKILL_POINT_COUNTER	Ocultar Notificacion de puntos de Habilidad
SETTINGS_NETWORK_HEADER_CLIENT_SETTINGS	Ajustes del Cliente
SETTINGS_NETWORK_CELL_ENABLE_PVP_ON_MAP_ENTER	Bandera para PvP si esta disponible
SETTINGS_BUTTON_RESET_TO_DEFAULTS	Restablecer por defecto
SETTINGS_BUTTON_RESET	Restablecer
SETTINGS_BUTTON_CANCEL	Cancelar
SETTINGS_BUTTON_APPLY	Aplicar
FORMAT_ITEM_RARITY	[{0}]
FORMAT_ITEM_TOOLTIP_VENDOR_VALUE_COUNTER	{0}
FORMAT_ITEM_TOOLTIP_VENDOR_VALUE_COUNTER_MULTIPLE	<color=grey>(x{0} each)</color> {1}
ITEM_TOOLTIP_GAMBLE_ITEM_NAME	Mystery Item
ITEM_TOOLTIP_GAMBLE_ITEM_RARITY	[Desconocido]
ITEM_TOOLTIP_GAMBLE_ITEM_DESCRIPTION	You can't really see what this is until you buy it.
ITEM_TOOLTIP_CONSUMABLE_DESCRIPTION_HEALTH_APPLY	Recupera {0} de Salud.
ITEM_TOOLTIP_CONSUMABLE_DESCRIPTION_MANA_APPLY	Recupera {0} de Mana.
ITEM_TOOLTIP_CONSUMABLE_DESCRIPTION_STAMINA_APPLY	Recupera {0} de Stamina.
ITEM_TOOLTIP_CONSUMABLE_DESCRIPTION_EXP_GAIN	Ganas {0} de Experiencia al usarse.
ITEM_TOOLTIP_TYPE_CONSUMABLE	Consumible
ITEM_TOOLTIP_TYPE_TRADE	Objecto de intercambio
EQUIP_TOOLTIP_GAMBLE_ITEM_NAME	Mystery Gear
EQUIP_TOOLTIP_GAMBLE_ITEM_RARITY	[Desconocido]
EQUIP_TOOLTIP_GAMBLE_ITEM_TYPE	???
EQUIP_TOOLTIP_GAMBLE_ITEM_DESCRIPTION	No puedes saber realmente que es hasta que lo compres.
FORMAT_EQUIP_LEVEL_REQUIREMENT	Nv-{0}
FORMAT_EQUIP_CLASS_REQUIREMENT	Clase: {0}
FORMAT_EQUIP_WEAPON_CONDITION	\n<color=lime>- <color=yellow>{0}%</color> chance to apply {1}.</color>
EQUIP_TOOLTIP_TYPE_HELM	Casco (Armadura)
EQUIP_TOOLTIP_TYPE_CHESTPIECE	Peto (Armadura)
EQUIP_TOOLTIP_TYPE_LEGGINGS	Pantalones (Armadira)
EQUIP_TOOLTIP_TYPE_CAPE	Capa (Armadura)
EQUIP_TOOLTIP_TYPE_RING	Anillo (Armadura)
FORMAT_EQUIP_TOOLTIP_TYPE_WEAPON	{0} (Arma)
EQUIP_TOOLTIP_TYPE_SHIELD	Escudo
FORMAT_EQUIP_STATS_DAMAGE_SCALED	<color=#c5e384>({0} - {1})</color> Daño
FORMAT_EQUIP_STATS_DAMAGE_SCALED_POWERFUL	<color=#efcc00>({0} - {1})</color> Daño
FORMAT_EQUIP_STATS_DAMAGE_COMPARE_BASE	\n<color=grey>(Daño base: {0} - {1})</color>
FORMAT_EQUIP_STATS_DAMAGE_UNSCALED	({0} - {1}) Daño
FORMAT_EQUIP_STATS_BLOCK_THRESHOLD	Umbral de proteccion: {0} de Daño
TAB_MENU_CELL_STATS_HEADER	Estadisticas
TAB_MENU_CELL_STATS_ATTRIBUTE_POINT_COUNTER	Puntos
TAB_MENU_CELL_STATS_BUTTON_APPLY_ATTRIBUTE_POINTS	Aplicar
TAB_MENU_CELL_STATS_INFO_CELL_NICK_NAME	Nombre
TAB_MENU_CELL_STATS_INFO_CELL_RACE_NAME	Raza
TAB_MENU_CELL_STATS_INFO_CELL_CLASS_NAME	Clase
TAB_MENU_CELL_STATS_INFO_CELL_LEVEL_COUNTER	Nivel
TAB_MENU_CELL_STATS_INFO_CELL_EXPERIENCE	Experiencia
TAB_MENU_CELL_STATS_INFO_CELL_MAX_HEALTH	Salud
TAB_MENU_CELL_STATS_INFO_CELL_MAX_MANA	Mana
TAB_MENU_CELL_STATS_INFO_CELL_MAX_STAMINA	Stamina
TAB_MENU_CELL_STATS_INFO_CELL_ATTACK	Attack Power
TAB_MENU_CELL_STATS_INFO_CELL_RANGED_POWER	Dex Power
TAB_MENU_CELL_STATS_INFO_CELL_PHYS_CRITICAL	Phys. Crit %
TAB_MENU_CELL_STATS_INFO_CELL_MAGIC_POW	Mgk. Power
TAB_MENU_CELL_STATS_INFO_CELL_MAGIC_CRIT	Mgk. Crit %
TAB_MENU_CELL_STATS_INFO_CELL_DEFENSE	Defensa
TAB_MENU_CELL_STATS_INFO_CELL_MAGIC_DEF	Mgk. Defensa
TAB_MENU_CELL_STATS_INFO_CELL_EVASION	Evasion %
TAB_MENU_CELL_STATS_INFO_CELL_MOVE_SPD	Mov Vel %
TAB_MENU_CELL_STATS_TOOLTIP_BASE_STAT_BEGIN	<b>Estadisticas base:</b> <i>
TAB_MENU_CELL_STATS_TOOLTIP_BASE_STAT_END_CRIT	%</i> (Critical %)
TAB_MENU_CELL_STATS_TOOLTIP_BASE_STAT_END_EVASION	%</i> (Evasion %)
TAB_MENU_CELL_STATS_TOOLTIP_BASE_STAT_FORMAT_ATTACK_POW	{0}</i> (Attack Power)
TAB_MENU_CELL_STATS_TOOLTIP_BASE_STAT_FORMAT_MAX_MP	{0}</i> (Max Mana)
TAB_MENU_CELL_STATS_TOOLTIP_BASE_STAT_FORMAT_MAX_HP	{0}</i> (Max. Salud)
TAB_MENU_CELL_STATS_TOOLTIP_BASE_STAT_FORMAT_RANGE_POW	{0}</i> (Dex Power)
TAB_MENU_CELL_STATS_TOOLTIP_BASE_STAT_END_MAGIC_CRIT	%</i> (Magic Critical %)
TAB_MENU_CELL_STATS_TOOLTIP_BASE_STAT_FORMAT_MAGIC_DEF	{0}</i> (Defensa Magica)
TAB_MENU_CELL_STATS_TOOLTIP_BASE_STAT_FORMAT_DEFENSE	{0}</i> (Defensa)
TAB_MENU_CELL_STATS_TOOLTIP_BASE_STAT_FORMAT_MAGIC_POW	{0}</i> (Poder Magico)
TAB_MENU_CELL_STATS_TOOLTIP_BASE_STAT_FORMAT_MAX_STAM	{0}</i> (Max Stamina)
TAB_MENU_CELL_SKILLS_HEADER	Skills
TAB_MENU_CELL_SKILLS_SKILL_POINT_COUNTER	Puntos de Habilidad
TAB_MENU_CELL_SKILLS_CLASS_TAB_TOOLTIP_NOVICE	Habilidades Generales
TAB_MENU_CELL_SKILLS_CLASS_TAB_TOOLTIP	{0} Habilidades
TAB_MENU_CELL_SKILLS_CLASS_HEADER_NOVICE	Skillbook Generales
TAB_MENU_CELL_SKILLS_CLASS_HEADER	{0} Skillbook
SKILL_RANK_SOULBOUND	Soulbound Skill
FORMAT_SKILL_RANK	[Rank {0} / {1}]
FORMAT_SKILL_TOOLTIP_DAMAGE_TYPE	{0} Habilidad
FORMAT_SKILL_TOOLTIP_ITEM_COST	x{0} {1}
FORMAT_SKILL_TOOLTIP_MANA_COST	{0} Mana
FORMAT_SKILL_TOOLTIP_HEALTH_COST	{0} Salud
FORMAT_SKILL_TOOLTIP_STAMINA_COST	{0} Stamina
SKILL_TOOLTIP_CAST_TIME_INSTANT	Instant Cast
FORMAT_SKILL_TOOLTIP_CAST_TIME	{0} sec Cast
FORMAT_SKILL_TOOLTIP_COOLDOWN	{0} sec Cooldown
SKILL_TOOLTIP_PASSIVE	Habilidad Passiva
SKILL_TOOLTIP_RANK_DESCRIPTOR_NEXT_RANK	\n<color=white><i>[Next Rank]</i></color>
FORMAT_SKILL_TOOLTIP_RANK_DESCRIPTOR_CURRENT_RANK	\n<color=white><i>[Rank {0}]</i></color>
FORMAT_SKILL_TOOLTIP_RANK_DESCRIPTOR_REQUIRED_LEVEL	<color=red>\n(Requieres Nv. {0})</color>
FORMAT_SKILL_TOOLTIP_RANK_DESCRIPTOR_COOLDOWN	<color=yellow>{0} sec cooldown.</color>
FORMAT_SKILL_TOOLTIP_RANK_DESCRIPTOR_CAST_TIME	<color=yellow>{0} sec cast time.</color>
SKILL_TOOLTIP_RANK_DESCRIPTOR_CAST_TIME_INSTANT	<color=yellow>instant cast time.</color>
SKILL_TOOLTIP_RANK_DESCRIPTOR_CONDITION_CANCEL_ON_HIT	 <color=yellow>Se cancela si te golpean.</color>
SKILL_TOOLTIP_RANK_DESCRIPTOR_CONDITION_IS_PERMANENT	 <color=yellow>Permanente.</color>
FORMAT_SKILL_TOOLTIP_RANK_DESCRIPTOR_CONDITION_DURATION	 <color=yellow>Lasts for {0} seconds.</color>
SKILL_TOOLTIP_RANK_DESCRIPTOR_CONDITION_IS_STACKABLE	 <color=yellow>Apilanble.</color>
SKILL_TOOLTIP_RANK_DESCRIPTOR_CONDITION_IS_REFRESHABLE	 <color=yellow>Se Actualiza si es reaplicado.</color>
FORMAT_QUEST_REQUIRED_LEVEL	(Nv-{0})
QUEST_TYPE_CLASS	(Tome de clase)
QUEST_TYPE_MASTERY	(Pergamino de maestria)
QUEST_MENU_SUMMARY_NO_QUESTS	No hay misiones disponibles
QUEST_MENU_HEADER_UNSELECTED	Selecciona Una mision
FORMAT_QUEST_MENU_CELL_QUEST_LOG_COUNTER	Quest Log: ({0} / {1})
FORMAT_QUEST_MENU_CELL_FINISHED_QUEST_COUNTER	Misiones completadas: {0}
FORMAT_QUEST_MENU_CELL_REWARD_EXP	{0} exp
FORMAT_QUEST_MENU_CELL_REWARD_CURRENCY	{0} Coronas
QUEST_MENU_CELL_SLOT_EMPTY	Espacio Vacio
QUEST_SELECTION_MANAGER_QUEST_ACCEPT_BUTTON_ACCEPT	Aceptar Mision
QUEST_SELECTION_MANAGER_QUEST_ACCEPT_BUTTON_LOCKED	Mision bloqueada
QUEST_SELECTION_MANAGER_QUEST_ACCEPT_BUTTON_INCOMPLETE	Mision incompleta
QUEST_SELECTION_MANAGER_QUEST_ACCEPT_BUTTON_TURN_IN	Mision Completa
QUEST_SELECTION_MANAGER_QUEST_ACCEPT_BUTTON_UNSELECTED	Selecciona Una mision
FORMAT_QUEST_PROGRESS	{0}: ({1} / {2})
FORMAT_QUEST_PROGRESS_CREEPS_KILLED	{0} slain
ITEM_LEATHER_CAP_NAME	Leather Cap
ITEM_LEATHER_CAP_DESCRIPTION	
ITEM_NEWFOLD_HALO_NAME	Newfold Halo
ITEM_NEWFOLD_HALO_DESCRIPTION	A sigil to indicate a new soul's introduction to the world.
ITEM_FOCUS_CIRCLET_NAME	Focus Circlet
ITEM_FOCUS_CIRCLET_DESCRIPTION	Keep still.
ITEM_JOURNEYMAN_SPECTACLES_NAME	Journeyman Spectacles
ITEM_JOURNEYMAN_SPECTACLES_DESCRIPTION	Used to read harder-- now with color!
ITEM_MAGISTRATE_CIRCLET_NAME	Magistrate Circlet
ITEM_MAGISTRATE_CIRCLET_DESCRIPTION	Clears the mind, putting things at ease.
ITEM_RAGE_CIRCLET_NAME	Rage Circlet
ITEM_RAGE_CIRCLET_DESCRIPTION	Fervor of angst and envy.
ITEM_GEISTLORD_CROWN_NAME	Geistlord Crown
ITEM_GEISTLORD_CROWN_DESCRIPTION	Can you handle the madness that ensues?
ITEM_NETHERCRYPT_HALO_NAME	Nethercrypt Halo
ITEM_NETHERCRYPT_HALO_DESCRIPTION	Banished crown from the nether realms.
ITEM_MITHRIL_HALO_NAME	Mithril Halo
ITEM_MITHRIL_HALO_DESCRIPTION	
ITEM_GLYPHGRIFT_HALO_NAME	Glyphgrift Halo
ITEM_GLYPHGRIFT_HALO_DESCRIPTION	
ITEM_JESTERCAST_MEMORY_NAME	Jestercast Memory
ITEM_JESTERCAST_MEMORY_DESCRIPTION	The true fool is the enemy of the caster...
ITEM_KNIGHTGUARD_HALO_NAME	Knightguard Halo
ITEM_KNIGHTGUARD_HALO_DESCRIPTION	Visions of might and prowess.
ITEM_GEISTLORD_EYE_NAME	Geistlord Eye
ITEM_GEISTLORD_EYE_DESCRIPTION	Madness beyond comprehension.
ITEM_INITIATE_SPECTACLES_NAME	Initiate Spectacles
ITEM_INITIATE_SPECTACLES_DESCRIPTION	Used to read.
ITEM_CRYPTSINGE_HALO_NAME	Cryptsinge Halo
ITEM_CRYPTSINGE_HALO_DESCRIPTION	Rumination of the dead.
ITEM_DIVA_CROWN_NAME	Diva Crown
ITEM_DIVA_CROWN_DESCRIPTION	A crown worn by a Slime Diva. Contains unusual power.
ITEM_IRON_HALO_NAME	Iron Halo
ITEM_IRON_HALO_DESCRIPTION	
ITEM_DEMICRYPT_HALO_NAME	Demicrypt Halo
ITEM_DEMICRYPT_HALO_DESCRIPTION	Fallen from corrupted angels.
ITEM_ACOLYTE_HOOD_NAME	Acolyte Hood
ITEM_ACOLYTE_HOOD_DESCRIPTION	Cultists are seen to wear this.
ITEM_DIRE_HELM_NAME	Dire Helm
ITEM_DIRE_HELM_DESCRIPTION	Once worn by a brave warrior.
ITEM_FESTIVE_HAT_NAME	Festive Hat
ITEM_FESTIVE_HAT_DESCRIPTION	Ho ho... ho!
ITEM_WIZARD_HAT_NAME	Wizard Hat
ITEM_WIZARD_HAT_DESCRIPTION	
ITEM_REGAZUUL_CAPE_NAME	Regazuul Cape
ITEM_REGAZUUL_CAPE_DESCRIPTION	A long forgotten heirloom of Lord Zuulneruda.
ITEM_COZY_CLOAK_NAME	Cozy Cloak
ITEM_COZY_CLOAK_DESCRIPTION	Keeps you warm in the cold weather.
ITEM_NETHERCRYPT_CLOAK_NAME	Nethercrypt Cloak
ITEM_NETHERCRYPT_CLOAK_DESCRIPTION	Rug for the feet of the dead.
ITEM_FORLORN_CLOAK_NAME	Forlorn Cloak
ITEM_FORLORN_CLOAK_DESCRIPTION	Forever lost.
ITEM_MESHLINK_CAPE_NAME	Meshlink Cape
ITEM_MESHLINK_CAPE_DESCRIPTION	Evasive and light.
ITEM_SAGECALLER_CAPE_NAME	Sagecaller Cape
ITEM_SAGECALLER_CAPE_DESCRIPTION	Brimming with magical power.
ITEM_COBBLERAGE_CLOAK_NAME	Cobblerage Cloak
ITEM_COBBLERAGE_CLOAK_DESCRIPTION	You feel strong like a golem wearing this.
ITEM_DEATHWARD_CAPE_NAME	Deathward Cape
ITEM_DEATHWARD_CAPE_DESCRIPTION	You can hear the laughter from the skull motif.
ITEM_INITIATE_CLOAK_NAME	Initiate Cloak
ITEM_INITIATE_CLOAK_DESCRIPTION	New beginnings.
ITEM_NOKKET_CLOAK_NAME	Nokket Cloak
ITEM_NOKKET_CLOAK_DESCRIPTION	
ITEM_RUGGED_CLOAK_NAME	Rugged Cloak
ITEM_RUGGED_CLOAK_DESCRIPTION	
ITEM_AERO_TOP_NAME	Aero Top
ITEM_AERO_TOP_DESCRIPTION	Common clothing worn by Byrdles.
ITEM_BUNHOST_GARB_NAME	Bunhost Garb
ITEM_BUNHOST_GARB_DESCRIPTION	
ITEM_FESTIVE_COAT_NAME	Festive Coat
ITEM_FESTIVE_COAT_DESCRIPTION	Tis the season...
ITEM_LEATHER_TOP_NAME	Leather Top
ITEM_LEATHER_TOP_DESCRIPTION	Common clothing worn by Poons.
ITEM_NECRO_MARROW_NAME	Necro Marrow
ITEM_NECRO_MARROW_DESCRIPTION	Common clothing worn by Imps.
ITEM_NOBLE_SHIRT_NAME	Noble Shirt
ITEM_NOBLE_SHIRT_DESCRIPTION	
ITEM_NUTSO_TOP_NAME	Nutso Top
ITEM_NUTSO_TOP_DESCRIPTION	Common clothing worn by Chang.
ITEM_SAGECLOTH_TOP_NAME	Sagecloth Top
ITEM_SAGECLOTH_TOP_DESCRIPTION	Common clothing worn by Kubolds.
ITEM_SILKEN_TOP_NAME	Silken Top
ITEM_SILKEN_TOP_DESCRIPTION	Ancient silk cloth. This could've been around since the very beginning of time...
ITEM_TEST_CHESTPIECE_NAME	Test Chestpiece
ITEM_TEST_CHESTPIECE_DESCRIPTION	Used to test texturing.
ITEM_VAMPIRIC_COAT_NAME	Vampiric Coat
ITEM_VAMPIRIC_COAT_DESCRIPTION	
ITEM_DUELIST_GARB_NAME	Duelist Garb
ITEM_DUELIST_GARB_DESCRIPTION	
ITEM_TATTERED_BATTLEROBE_NAME	Tattered Battlerobe
ITEM_TATTERED_BATTLEROBE_DESCRIPTION	
ITEM_WARRIOR_CHEST_NAME	Warrior Chest
ITEM_WARRIOR_CHEST_DESCRIPTION	
ITEM_SLEEPERS_ROBE_NAME	Sleeper's Robe
ITEM_SLEEPERS_ROBE_DESCRIPTION	So tired...
ITEM_LORD_BREASTPLATE_NAME	Lord Breastplate
ITEM_LORD_BREASTPLATE_DESCRIPTION	Hail the Lord!
ITEM_REAPSOW_GARB_NAME	Reapsow Garb
ITEM_REAPSOW_GARB_DESCRIPTION	Fear the hidden.
ITEM_WITCHLOCK_ROBE_NAME	Witchlock Robe
ITEM_WITCHLOCK_ROBE_DESCRIPTION	Robe of the elite occult.
ITEM_GOLEM_CHESTPIECE_NAME	Golem Chestpiece
ITEM_GOLEM_CHESTPIECE_DESCRIPTION	
ITEM_NETHERCRYPT_TABARD_NAME	Nethercrypt Tabard
ITEM_NETHERCRYPT_TABARD_DESCRIPTION	
ITEM_ORNAMENTED_BATTLEROBE_NAME	Ornamented Battlerobe
ITEM_ORNAMENTED_BATTLEROBE_DESCRIPTION	
ITEM_MERCENARY_VESTMENT_NAME	Mercenary Vestment
ITEM_MERCENARY_VESTMENT_DESCRIPTION	
ITEM_MITHRIL_CHESTPIECE_NAME	Mithril Chestpiece
ITEM_MITHRIL_CHESTPIECE_DESCRIPTION	
ITEM_CARBUNCLE_ROBE_NAME	Carbuncle Robe
ITEM_CARBUNCLE_ROBE_DESCRIPTION	The patterns on the cloth make an audible hum if you listen closely.
ITEM_FORTIFIED_VESTMENT_NAME	Fortified Vestment
ITEM_FORTIFIED_VESTMENT_DESCRIPTION	
ITEM_CHAINSCALE_CHEST_NAME	Chainscale Chest
ITEM_CHAINSCALE_CHEST_DESCRIPTION	
ITEM_GEMVEIL_RAIMENT_NAME	Gemveil Raiment
ITEM_GEMVEIL_RAIMENT_DESCRIPTION	Dazzling gems flicker on this loose but defensive chestpiece.
ITEM_KING_BREASTPLATE_NAME	King Breastplate
ITEM_KING_BREASTPLATE_DESCRIPTION	Bend the knee, to the King!
ITEM_MONOLITH_CHESTPIECE_NAME	Monolith Chestpiece
ITEM_MONOLITH_CHESTPIECE_DESCRIPTION	
ITEM_REAPER_GI_NAME	Reaper Gi
ITEM_REAPER_GI_DESCRIPTION	Worn by undead assassins.
ITEM_WITCHWIZARD_ROBE_NAME	Witchwizard Robe
ITEM_WITCHWIZARD_ROBE_DESCRIPTION	Robe of the higher elite occult.
ITEM_SLIMECRUST_CHEST_NAME	Slimecrust Chest
ITEM_SLIMECRUST_CHEST_DESCRIPTION	Cracked and ravaged by slime.
ITEM_WORN_ROBE_NAME	Worn Robe
ITEM_WORN_ROBE_DESCRIPTION	Definitely been worn many times.
ITEM_CHAINMAIL_GUARD_NAME	Chainmail Guard
ITEM_CHAINMAIL_GUARD_DESCRIPTION	
ITEM_BERSERKER_CHESTPIECE_NAME	Berserker Chestpiece
ITEM_BERSERKER_CHESTPIECE_DESCRIPTION	
ITEM_FUGUEFALL_DUSTER_NAME	Fuguefall Duster
ITEM_FUGUEFALL_DUSTER_DESCRIPTION	
ITEM_MAGILORD_OVERALLS_NAME	Magilord Overalls
ITEM_MAGILORD_OVERALLS_DESCRIPTION	Devout mystic sages of ancient times worn these in ceremonies.
ITEM_JOURNEYMAN_VEST_NAME	Journeyman Vest
ITEM_JOURNEYMAN_VEST_DESCRIPTION	
ITEM_POACHER_CLOTH_NAME	Poacher Cloth
ITEM_POACHER_CLOTH_DESCRIPTION	Slightly veiled.
ITEM_GHOSTLY_TABARD_NAME	Ghostly Tabard
ITEM_GHOSTLY_TABARD_DESCRIPTION	
ITEM_CRYPTSINGE_CHEST_NAME	Cryptsinge Chest
ITEM_CRYPTSINGE_CHEST_DESCRIPTION	
ITEM_SLIMEK_CHEST_NAME	Slimek Chest
ITEM_SLIMEK_CHEST_DESCRIPTION	Sturdy enough to widthstand some further damage.
ITEM_IRON_CHESTPIECE_NAME	Iron Chestpiece
ITEM_IRON_CHESTPIECE_DESCRIPTION	
ITEM_AERO_PANTS_NAME	Aero Pants
ITEM_AERO_PANTS_DESCRIPTION	Common clothing worn by Byrdles.
ITEM_BUNHOST_LEGGINGS_NAME	Bunhost Leggings
ITEM_BUNHOST_LEGGINGS_DESCRIPTION	
ITEM_FESTIVE_TROUSERS_NAME	Festive Trousers
ITEM_FESTIVE_TROUSERS_DESCRIPTION	Merry pantsmas!
ITEM_LEATHER_BRITCHES_NAME	Leather Britches
ITEM_LEATHER_BRITCHES_DESCRIPTION	Common clothing worn by Poons.
ITEM_NECRO_CAUSTICS_NAME	Necro Caustics
ITEM_NECRO_CAUSTICS_DESCRIPTION	Common clothing worn by Imps.
ITEM_NOBLE_PANTS_NAME	Noble Pants
ITEM_NOBLE_PANTS_DESCRIPTION	
ITEM_NUTSO_PANTS_NAME	Nutso Pants
ITEM_NUTSO_PANTS_DESCRIPTION	Common clothing worn by Changs.
ITEM_SAGECLOTH_SHORTS_NAME	Sagecloth Shorts
ITEM_SAGECLOTH_SHORTS_DESCRIPTION	Common clothing worn by Kubolds.
ITEM_SILKEN_LOINCLOTH_NAME	Silken Loincloth
ITEM_SILKEN_LOINCLOTH_DESCRIPTION	Ancient loincloth.
ITEM_TEST_PANTS_NAME	Test Pants
ITEM_TEST_PANTS_DESCRIPTION	Used to view texturing.
ITEM_VAMPIRIC_LEGGINGS_NAME	Vampiric Leggings
ITEM_VAMPIRIC_LEGGINGS_DESCRIPTION	
ITEM_SASH_LEGGINGS_NAME	Sash Leggings
ITEM_SASH_LEGGINGS_DESCRIPTION	Tight.
ITEM_WARRIOR_LEGGINGS_NAME	Warrior Leggings
ITEM_WARRIOR_LEGGINGS_DESCRIPTION	
ITEM_LORD_GREAVES_NAME	Lord Greaves
ITEM_LORD_GREAVES_DESCRIPTION	Your pants, sire?
ITEM_REAPSOW_PANTS_NAME	Reapsow Pants
ITEM_REAPSOW_PANTS_DESCRIPTION	
ITEM_WITCHLOCK_LOINCLOTH_NAME	Witchlock Loincloth
ITEM_WITCHLOCK_LOINCLOTH_DESCRIPTION	
ITEM_CHAINMAIL_LEGGINGS_NAME	Chainmail Leggings
ITEM_CHAINMAIL_LEGGINGS_DESCRIPTION	
ITEM_MERCENARY_LEGGINGS_NAME	Mercenary Leggings
ITEM_MERCENARY_LEGGINGS_DESCRIPTION	
ITEM_DARKCLOTH_PANTS_NAME	Darkcloth Pants
ITEM_DARKCLOTH_PANTS_DESCRIPTION	
ITEM_STRIDEBOND_PANTS_NAME	Stridebond Pants
ITEM_STRIDEBOND_PANTS_DESCRIPTION	
ITEM_KING_GREAVES_NAME	King Greaves
ITEM_KING_GREAVES_DESCRIPTION	Your pants, my liege?
ITEM_REAPER_LEGGINGS_NAME	Reaper Leggings
ITEM_REAPER_LEGGINGS_DESCRIPTION	
ITEM_WITCHWIZARD_GARTERBELT_NAME	Witchwizard Garterbelt
ITEM_WITCHWIZARD_GARTERBELT_DESCRIPTION	
ITEM_SLIMECRUST_LEGGINGS_NAME	Slimecrust Leggings
ITEM_SLIMECRUST_LEGGINGS_DESCRIPTION	Drenched in slime.
ITEM_BERSERKER_LEGGINGS_NAME	Berserker Leggings
ITEM_BERSERKER_LEGGINGS_DESCRIPTION	
ITEM_FUGUEFALL_PANTS_NAME	Fuguefall Pants
ITEM_FUGUEFALL_PANTS_DESCRIPTION	
ITEM_MAGILORD_BOOTS_NAME	Magilord Boots
ITEM_MAGILORD_BOOTS_DESCRIPTION	Keeps the toes warm.
ITEM_GHOSTLY_LEGWRAPS_NAME	Ghostly Legwraps
ITEM_GHOSTLY_LEGWRAPS_DESCRIPTION	Wearing these make your legs feel numb.
ITEM_JOURNEYMAN_SHORTS_NAME	Journeyman Shorts
ITEM_JOURNEYMAN_SHORTS_DESCRIPTION	
ITEM_SLIMEK_LEGGINGS_NAME	Slimek Leggings
ITEM_SLIMEK_LEGGINGS_DESCRIPTION	Drenched in Slimek slime.
ITEM_JOURNEYMAN_LEGGINGS_NAME	Journeyman Leggings
ITEM_JOURNEYMAN_LEGGINGS_DESCRIPTION	
ITEM_WOODEN_SHIELD_NAME	Wooden Shield
ITEM_WOODEN_SHIELD_DESCRIPTION	
ITEM_IRIS_SHIELD_NAME	Iris Shield
ITEM_IRIS_SHIELD_DESCRIPTION	Invoker of arcane tears.
ITEM_OMEN_SHIELD_NAME	Omen Shield
ITEM_OMEN_SHIELD_DESCRIPTION	Something's intimidating about the design.
ITEM_NETHERCRYPT_SHIELD_NAME	Nethercrypt Shield
ITEM_NETHERCRYPT_SHIELD_DESCRIPTION	Emblem of the twisted nether realm.
ITEM_MITHRIL_SHIELD_NAME	Mithril Shield
ITEM_MITHRIL_SHIELD_DESCRIPTION	
ITEM_RUSTWEARY_SHIELD_NAME	Rustweary Shield
ITEM_RUSTWEARY_SHIELD_DESCRIPTION	The face is worried.
ITEM_RUSTWISE_SHIELD_NAME	Rustwise Shield
ITEM_RUSTWISE_SHIELD_DESCRIPTION	The face is confident.
ITEM_CRYPT_BUCKLER_NAME	Crypt Buckler
ITEM_CRYPT_BUCKLER_DESCRIPTION	Used by ancient warriors of the past.
ITEM_DEMICRYPT_BUCKLER_NAME	Demicrypt Buckler
ITEM_DEMICRYPT_BUCKLER_DESCRIPTION	An emblem of an ancient sarcophogus.
ITEM_IRON_SHIELD_NAME	Iron Shield
ITEM_IRON_SHIELD_DESCRIPTION	
ITEM_OLD_RING_NAME	Old Ring
ITEM_OLD_RING_DESCRIPTION	
ITEM_RING_OF_AMBITION_NAME	Ring Of Ambition
ITEM_RING_OF_AMBITION_DESCRIPTION	Something strikes you about this ring.
ITEM_TEST_RING_NAME	Test Ring
ITEM_TEST_RING_DESCRIPTION	It was once possible to get this. If you have it, you must've been around for a while...
ITEM_GEISTLORD_RING_NAME	Geistlord Ring
ITEM_GEISTLORD_RING_DESCRIPTION	Whispers of Zuulneruda's memories echo and reverberate inside your soul.
ITEM_STUDENTS_RING_NAME	Students Ring
ITEM_STUDENTS_RING_DESCRIPTION	Excelsior!
ITEM_PEARLPOND_RING_NAME	Pearlpond Ring
ITEM_PEARLPOND_RING_DESCRIPTION	The pearls chime, providing a peace of mind and clarity.
ITEM_SLITHERWRAITH_RING_NAME	Slitherwraith Ring
ITEM_SLITHERWRAITH_RING_DESCRIPTION	Slither through and past the doors.
ITEM_ORBOS_RING_NAME	Orbos Ring
ITEM_ORBOS_RING_DESCRIPTION	
ITEM_JADETROUT_RING_NAME	Jadetrout Ring
ITEM_JADETROUT_RING_DESCRIPTION	The tail of the fish on this ring moves rapidly.
ITEM_VALOR_RING_NAME	Valor Ring
ITEM_VALOR_RING_DESCRIPTION	
ITEM_GEISTLORD_BAND_NAME	Geistlord Band
ITEM_GEISTLORD_BAND_DESCRIPTION	Whispers of Kaluuz's memories echo and reverberate inside your soul.
ITEM_EARTHWOKEN_RING_NAME	Earthwoken Ring
ITEM_EARTHWOKEN_RING_DESCRIPTION	The gems glimmer much like the gems of a Colossus.
ITEM_AMBERSQUIRE_RING_NAME	Ambersquire Ring
ITEM_AMBERSQUIRE_RING_DESCRIPTION	Tough as nails.
ITEM_EMERALDFOCUS_RING_NAME	Emeraldfocus Ring
ITEM_EMERALDFOCUS_RING_DESCRIPTION	The emerald glistens even from afar.
ITEM_SAPPHIREWEAVE_RING_NAME	Sapphireweave Ring
ITEM_SAPPHIREWEAVE_RING_DESCRIPTION	Sounds of the ocean waves through your ears.
ITEM_WOOD_DAGGERS_NAME	Wood Daggers
ITEM_WOOD_DAGGERS_DESCRIPTION	
ITEM_RUNIC_KATARS_NAME	Runic Katars
ITEM_RUNIC_KATARS_DESCRIPTION	Forged by a sadistic being of torture.
ITEM_GEISTLORD_CLAWS_NAME	Geistlord Claws
ITEM_GEISTLORD_CLAWS_DESCRIPTION	Shreds through the wailing souls.
ITEM_HELLSLUDGE_SHIVS_NAME	Hellsludge Shivs
ITEM_HELLSLUDGE_SHIVS_DESCRIPTION	Hot, hot, hot to the touch!
ITEM_MITHRIL_KATARS_NAME	Mithril Katars
ITEM_MITHRIL_KATARS_DESCRIPTION	
ITEM_SERRATED_KNUCKLES_NAME	Serrated Knuckles
ITEM_SERRATED_KNUCKLES_DESCRIPTION	
ITEM_FROSTBITE_CLAWS_NAME	Frostbite Claws
ITEM_FROSTBITE_CLAWS_DESCRIPTION	Cold to the touch...
ITEM_GOLEMFIST_KATARS_NAME	Golemfist Katars
ITEM_GOLEMFIST_KATARS_DESCRIPTION	Pow!
ITEM_SLIMECRUST_KATARS_NAME	Slimecrust Katars
ITEM_SLIMECRUST_KATARS_DESCRIPTION	Iron Katars that have been dulled by slime.
ITEM_SLIMEK_SHIVS_NAME	Slimek Shivs
ITEM_SLIMEK_SHIVS_DESCRIPTION	These ears of a Slimek seem to be usable for combat...
ITEM_DEATHGEL_SHIVS_NAME	Deathgel Shivs
ITEM_DEATHGEL_SHIVS_DESCRIPTION	Rotted, deadly Deathgel ears.
ITEM_IRON_KATARS_NAME	Iron Katars
ITEM_IRON_KATARS_DESCRIPTION	
ITEM_WOODEN_BOW_NAME	Wooden Bow
ITEM_WOODEN_BOW_DESCRIPTION	
ITEM_MENACE_BOW_NAME	Menace Bow
ITEM_MENACE_BOW_DESCRIPTION	You feel a surge of swiftness holding this bow.
ITEM_PETRIFIED_BOW_NAME	Petrified Bow
ITEM_PETRIFIED_BOW_DESCRIPTION	Lost souls of the damned are welded to this bow.
ITEM_NECROROYAL_BOW_NAME	Necroroyal Bow
ITEM_NECROROYAL_BOW_DESCRIPTION	
ITEM_MITHRIL_BOW_NAME	Mithril Bow
ITEM_MITHRIL_BOW_DESCRIPTION	
ITEM_SERRATED_LONGBOW_NAME	Serrated Longbow
ITEM_SERRATED_LONGBOW_DESCRIPTION	Sharp and twisted. Fires arrows that pierce.
ITEM_COLDGEIST_BOW_NAME	Coldgeist Bow
ITEM_COLDGEIST_BOW_DESCRIPTION	Ruination of the lost frozen souls.
ITEM_CRYPT_BOW_NAME	Crypt Bow
ITEM_CRYPT_BOW_DESCRIPTION	Glue-like soot keeps the bones together.
ITEM_DEMICRYPT_BOW_NAME	Demicrypt Bow
ITEM_DEMICRYPT_BOW_DESCRIPTION	The bones holding this bow together seem fresh.
ITEM_IRON_BOW_NAME	Iron Bow
ITEM_IRON_BOW_DESCRIPTION	
ITEM_MEKSPIKE_BOW_NAME	Mekspike Bow
ITEM_MEKSPIKE_BOW_DESCRIPTION	The construct of this bow is similar of a Mekboar.
ITEM_WOOD_SWORD_NAME	Wood Sword
ITEM_WOOD_SWORD_DESCRIPTION	
ITEM_DAWN_MACE_NAME	Dawn Mace
ITEM_DAWN_MACE_DESCRIPTION	Clubbed to death.
ITEM_RUDE_BLADE_NAME	Rude Blade
ITEM_RUDE_BLADE_DESCRIPTION	Don't you have anything better to kill?
ITEM_VILE_BLADE_NAME	Vile Blade
ITEM_VILE_BLADE_DESCRIPTION	A Rude Blade, but more... vile.
ITEM_NETHERCRYPT_BLADE_NAME	Nethercrypt Blade
ITEM_NETHERCRYPT_BLADE_DESCRIPTION	Twisted, infused with nether magic.
ITEM_MITHRIL_SWORD_NAME	Mithril Sword
ITEM_MITHRIL_SWORD_DESCRIPTION	
ITEM_SERRATED_BLADE_NAME	Serrated Blade
ITEM_SERRATED_BLADE_DESCRIPTION	
ITEM_COLDGEIST_BLADE_NAME	Coldgeist Blade
ITEM_COLDGEIST_BLADE_DESCRIPTION	Forged from corrupted frost, formally used by ancient sages.
ITEM_SLIMECRUST_BLADE_NAME	Slimecrust Blade
ITEM_SLIMECRUST_BLADE_DESCRIPTION	Looks to be an Iron Sword, but the blade is intensely dulled by slime.
ITEM_CRYPT_BLADE_NAME	Crypt Blade
ITEM_CRYPT_BLADE_DESCRIPTION	The sharped blade was a bone of a madman.
ITEM_GILDED_SWORD_NAME	Gilded Sword
ITEM_GILDED_SWORD_DESCRIPTION	Looks to have a worn out blade, but still sharp enough for it to do some damage.
ITEM_IRON_SWORD_NAME	Iron Sword
ITEM_IRON_SWORD_DESCRIPTION	
ITEM_DEMICRYPT_BLADE_NAME	Demicrypt Blade
ITEM_DEMICRYPT_BLADE_DESCRIPTION	Whispers of the dead are sealed in this sword.
ITEM_WOOD_HAMMER_NAME	Wood Hammer
ITEM_WOOD_HAMMER_DESCRIPTION	
ITEM_CRYPT_POUNDER_NAME	Crypt Pounder
ITEM_CRYPT_POUNDER_DESCRIPTION	Made with the bones of sinners.
ITEM_STONE_GREATBLADE_NAME	Stone Greatblade
ITEM_STONE_GREATBLADE_DESCRIPTION	
ITEM_POLTERGEIST_SCYTHE_NAME	Poltergeist Scythe
ITEM_POLTERGEIST_SCYTHE_DESCRIPTION	The highest tier of a Geist's scythe.
ITEM_MITHRIL_GREATSWORD_NAME	Mithril Greatsword
ITEM_MITHRIL_GREATSWORD_DESCRIPTION	
ITEM_DEADWOOD_AXE_NAME	Deadwood Axe
ITEM_DEADWOOD_AXE_DESCRIPTION	This was wedged deep into a Deadwood. Origins of the cause is a mystery.
ITEM_COLDGEIST_PUNISHER_NAME	Coldgeist Punisher
ITEM_COLDGEIST_PUNISHER_DESCRIPTION	The blade of the axe is forever frigid.
ITEM_QUAKE_PUMMELER_NAME	Quake Pummeler
ITEM_QUAKE_PUMMELER_DESCRIPTION	Smash them all into oblivion.
ITEM_MINI_GEIST_SCYTHE_NAME	Mini Geist Scythe
ITEM_MINI_GEIST_SCYTHE_DESCRIPTION	The only best friend of a Mini Geist. The blade emanates menacingly.
ITEM_SLIMEK_AXEHAMMER_NAME	Slimek Axehammer
ITEM_SLIMEK_AXEHAMMER_DESCRIPTION	An Iron Axehammer that's seen better days. It's a little bit of a challenge to maintain a grip on this thing.
ITEM_IRON_AXEHAMMER_NAME	Iron Axehammer
ITEM_IRON_AXEHAMMER_DESCRIPTION	
ITEM_GEIST_SCYTHE_NAME	Geist Scythe
ITEM_GEIST_SCYTHE_DESCRIPTION	The souls of the damned resonate within the blade.
ITEM_MEKSPEAR_NAME	Mekspear
ITEM_MEKSPEAR_DESCRIPTION	A usable partisan with a Mekboar's spear attached to it.
ITEM_SINNER_BARDICHE_NAME	Sinner Bardiche
ITEM_SINNER_BARDICHE_DESCRIPTION	Blood of the sinners coat this weapon.
ITEM_NECROROYAL_HALBERD_NAME	Necroroyal Halberd
ITEM_NECROROYAL_HALBERD_DESCRIPTION	Used by the royal guard of the undead.
ITEM_MITHRIL_HALBERD_NAME	Mithril Halberd
ITEM_MITHRIL_HALBERD_DESCRIPTION	
ITEM_RAGESPEAR_NAME	Ragespear
ITEM_RAGESPEAR_DESCRIPTION	The tip of the spear looks bloody, but it appears to be a corrosive material.
ITEM_SERRATED_SPEAR_NAME	Serrated Spear
ITEM_SERRATED_SPEAR_DESCRIPTION	
ITEM_WOOD_SPEAR_NAME	Wood Spear
ITEM_WOOD_SPEAR_DESCRIPTION	
ITEM_IRON_SPEAR_NAME	Iron Spear
ITEM_IRON_SPEAR_DESCRIPTION	
ITEM_CRYPTSINGE_HALBERD_NAME	Cryptsinge Halberd
ITEM_CRYPTSINGE_HALBERD_DESCRIPTION	Poke and prod the undead into submission.
ITEM_WOOD_SCEPTER_NAME	Wood Scepter
ITEM_WOOD_SCEPTER_DESCRIPTION	
ITEM_CRYO_CANE_NAME	Cryo Cane
ITEM_CRYO_CANE_DESCRIPTION	Let them freeze.
ITEM_SLIME_DIVA_BATON_NAME	Slime Diva Baton
ITEM_SLIME_DIVA_BATON_DESCRIPTION	Only a Slime Diva can truly maximize the full potential of this Scepter.
ITEM_PYRE_CANE_NAME	Pyre Cane
ITEM_PYRE_CANE_DESCRIPTION	Let them burn.
ITEM_WIZWAND_NAME	Wizwand
ITEM_WIZWAND_DESCRIPTION	Electrifying.
ITEM_NETHERCRYPT_BAUBLE_NAME	Nethercrypt Bauble
ITEM_NETHERCRYPT_BAUBLE_DESCRIPTION	It's hard to comprehend how terrible the malformed skull is.
ITEM_MITHRIL_SCEPTER_NAME	Mithril Scepter
ITEM_MITHRIL_SCEPTER_DESCRIPTION	
ITEM_AQUAPETAL_STAFF_NAME	Aquapetal Staff
ITEM_AQUAPETAL_STAFF_DESCRIPTION	
ITEM_FLAMEPETAL_STAFF_NAME	Flamepetal Staff
ITEM_FLAMEPETAL_STAFF_DESCRIPTION	
ITEM_SPLITBARK_SCEPTER_NAME	Splitbark Scepter
ITEM_SPLITBARK_SCEPTER_DESCRIPTION	Warmth eminates from the bright white gems.
ITEM_MARROW_BAUBLE_NAME	Marrow Bauble
ITEM_MARROW_BAUBLE_DESCRIPTION	Who's skull is this?
ITEM_IRON_SCEPTER_NAME	Iron Scepter
ITEM_IRON_SCEPTER_DESCRIPTION	
ITEM_DEMICRYPT_BAUBLE_NAME	Demicrypt Bauble
ITEM_DEMICRYPT_BAUBLE_DESCRIPTION	The skull doesn't seem real.
ITEM_CRYPTCALL_BELL_NAME	Cryptcall Bell
ITEM_CRYPTCALL_BELL_DESCRIPTION	The bell tolls for the dead.
ITEM_MITHRIL_BELL_NAME	Mithril Bell
ITEM_MITHRIL_BELL_DESCRIPTION	
ITEM_COLDGEIST_FROSTCALLER_NAME	Coldgeist Frostcaller
ITEM_COLDGEIST_FROSTCALLER_DESCRIPTION	Used to awaken Geistlords with its spine chilling tone.
ITEM_COLOSSUS_TONE_NAME	Colossus Tone
ITEM_COLOSSUS_TONE_DESCRIPTION	Pieces of a Colossus are embedded into this bell.
ITEM_WOODEN_BELL_NAME	Wooden Bell
ITEM_WOODEN_BELL_DESCRIPTION	The weapon is made of wood, but it chimes as if it's metal.
ITEM_IRON_BELL_NAME	Iron Bell
ITEM_IRON_BELL_DESCRIPTION	
ITEM_TOME_OF_THE_BANDIT_NAME	Tome of the Bandit
ITEM_TOME_OF_THE_BANDIT_DESCRIPTION	<color=lime>Can only be used in a Safe Zone.</color>\n\nReading this tome teaches you to be the <color=lime>nimble Bandit class.</color> Additionally resets and reimburses your Skill Points. Not reversible. 
ITEM_TOME_OF_THE_FIGHTER_NAME	Tome of the Fighter
ITEM_TOME_OF_THE_FIGHTER_DESCRIPTION	<color=lime>Can only be used in a Safe Zone.</color>\n\nReading this tome teaches you to be the <color=red>fierce Fighter class.</color> Additionally resets and reimburses your Skill Points. Not reversible.
ITEM_TOME_OF_THE_MYSTIC_NAME	Tome of the Mystic
ITEM_TOME_OF_THE_MYSTIC_DESCRIPTION	<color=lime>Can only be used in a Safe Zone.</color>\n\nReading this tome teaches you to be the <color=cyan>wise Mystic class.</color> Additionally resets and reimburses your Skill Points. Not reversible.
ITEM_BLUE_DYE_NAME	Blue Dye
ITEM_BLUE_DYE_DESCRIPTION	A vial of blue dye. Use it to make your gear dye color blue.
ITEM_GREEN_DYE_NAME	Green Dye
ITEM_GREEN_DYE_DESCRIPTION	A vial of green dye. Use it to make your gear dye color green.
ITEM_GREY_DYE_NAME	Grey Dye
ITEM_GREY_DYE_DESCRIPTION	A vial of grey dye. Use it to make your gear dye color grey.
ITEM_RED_DYE_NAME	Red Dye
ITEM_RED_DYE_DESCRIPTION	A vial of red dye. Use it to make your gear dye color red.
ITEM_SKILL_SCROLL_ALACRITY_NAME	Skill Scroll (Alacrity)
ITEM_SKILL_SCROLL_ALACRITY_DESCRIPTION	Teaches the user Alacrity.
ITEM_SKILL_SCROLL_CRYO_NEEDLE_NAME	Skill Scroll (Cryo Needle)
ITEM_SKILL_SCROLL_CRYO_NEEDLE_DESCRIPTION	Teaches the user Cryo Needle.
ITEM_SKILL_SCROLL_EXECUTE_NAME	Skill Scroll (Execute)
ITEM_SKILL_SCROLL_EXECUTE_DESCRIPTION	Teaches the user Execute.
ITEM_SKILL_SCROLL_FIREBALL_NAME	Skill Scroll (Fireball)
ITEM_SKILL_SCROLL_FIREBALL_DESCRIPTION	Teaches the user Fireball.
ITEM_SKILL_SCROLL_INNER_FOCUS_NAME	Skill Scroll (Inner Focus)
ITEM_SKILL_SCROLL_INNER_FOCUS_DESCRIPTION	Teaches the user Inner Focus.
ITEM_SKILL_SCROLL_LEG_UP_NAME	Skill Scroll (Leg Up)
ITEM_SKILL_SCROLL_LEG_UP_DESCRIPTION	Teaches the user Leg Up.
ITEM_SKILL_SCROLL_SIPHON_LEECH_NAME	Skill Scroll (Siphon Leech)
ITEM_SKILL_SCROLL_SIPHON_LEECH_DESCRIPTION	Teaches the user Siphon Leech.
ITEM_SKILL_SCROLL_SPIRE_NAME	Skill Scroll (Spire)
ITEM_SKILL_SCROLL_SPIRE_DESCRIPTION	Teaches the user Spire.
ITEM_SKILL_SCROLL_SPREAD_SHOT_NAME	Skill Scroll (Spread Shot)
ITEM_SKILL_SCROLL_SPREAD_SHOT_DESCRIPTION	Teaches the user Spread Shot.
ITEM_SKILL_SCROLL_STURDY_NAME	Skill Scroll (Sturdy)
ITEM_SKILL_SCROLL_STURDY_DESCRIPTION	Teaches the user Sturdy.
ITEM_SKILL_SCROLL_BELL_MASTERY_NAME	Skill Scroll (Bell Mastery)
ITEM_SKILL_SCROLL_BELL_MASTERY_DESCRIPTION	Teaches the user Bell Mastery.
ITEM_SKILL_SCROLL_HEAVY_MELEE_MASTERY_NAME	Skill Scroll (Heavy Melee Mastery)
ITEM_SKILL_SCROLL_HEAVY_MELEE_MASTERY_DESCRIPTION	Teaches the user Heavy Melee Mastery.
ITEM_SKILL_SCROLL_KATAR_MASTERY_NAME	Skill Scroll (Katar Mastery)
ITEM_SKILL_SCROLL_KATAR_MASTERY_DESCRIPTION	Teaches the user Katar Mastery.
ITEM_SKILL_SCROLL_MELEE_MASTERY_NAME	Skill Scroll (Melee Mastery)
ITEM_SKILL_SCROLL_MELEE_MASTERY_DESCRIPTION	Teaches the user Melee Mastery.
ITEM_SKILL_SCROLL_POLEARM_MASTERY_NAME	Skill Scroll (Polearm Mastery)
ITEM_SKILL_SCROLL_POLEARM_MASTERY_DESCRIPTION	Teaches the user Polearm Mastery.
ITEM_SKILL_SCROLL_RANGED_MASTERY_NAME	Skill Scroll (Ranged Mastery)
ITEM_SKILL_SCROLL_RANGED_MASTERY_DESCRIPTION	Teaches the user Ranged Mastery.
ITEM_SKILL_SCROLL_SCEPTER_MASTERY_NAME	Skill Scroll (Scepter Mastery)
ITEM_SKILL_SCROLL_SCEPTER_MASTERY_DESCRIPTION	Teaches the user Scepter Mastery.
ITEM_SKILL_SCROLL_DIVINE_NAME	Skill Scroll (Divine)
ITEM_SKILL_SCROLL_DIVINE_DESCRIPTION	Teaches the user Divine.
ITEM_SKILL_SCROLL_LIFE_TAP_NAME	Skill Scroll (Life Tap)
ITEM_SKILL_SCROLL_LIFE_TAP_DESCRIPTION	Teaches the user Life Tap.
ITEM_BUNBAG_NAME	Bunbag
ITEM_BUNBAG_DESCRIPTION	A gratuitous healing salve.
ITEM_BUNJAR_NAME	Bunjar
ITEM_BUNJAR_DESCRIPTION	A big healing salve.
ITEM_BUNPOT_NAME	Bunpot
ITEM_BUNPOT_DESCRIPTION	A small healing salve.
ITEM_CARROT_CAKE_NAME	Carrot Cake
ITEM_CARROT_CAKE_DESCRIPTION	A delicious treat amongst Sanctum.
ITEM_MAGICLOVE_NAME	Magiclove
ITEM_MAGICLOVE_DESCRIPTION	A large mind replenishing clove.
ITEM_MAGIFLOWER_NAME	Magiflower
ITEM_MAGIFLOWER_DESCRIPTION	A gratuitous mind replenishing flower.
ITEM_MAGILEAF_NAME	Magileaf
ITEM_MAGILEAF_DESCRIPTION	A small mind replenishing leaf.
ITEM_SPECTRAL_POWDER_NAME	Spectral Powder
ITEM_SPECTRAL_POWDER_DESCRIPTION	Potent mixture of grounded ghostly substance. Vanishes the user for a short duration.
ITEM_STAMSTAR_NAME	Stamstar
ITEM_STAMSTAR_DESCRIPTION	Clenching this star gives a sudden boost of energy.
ITEM_MINCHROOM_JUICE_NAME	Minchroom Juice
ITEM_MINCHROOM_JUICE_DESCRIPTION	Tasty Minchroom blood.
ITEM_LESSER_DEFENSE_POTION_NAME	Lesser Defense Potion
ITEM_LESSER_DEFENSE_POTION_DESCRIPTION	Temporarily increases Defense by 5.
ITEM_LESSER_EVASION_POTION_NAME	Lesser Evasion Potion
ITEM_LESSER_EVASION_POTION_DESCRIPTION	Temporarily increases Evasion by 3%.
ITEM_LESSER_MGK_DEFENSE_POTION_NAME	Lesser Mgk. Defense Potion
ITEM_LESSER_MGK_DEFENSE_POTION_DESCRIPTION	Temporarily increases Magic Defense by 5.
ITEM_LESSER_REGENERATION_POTION_NAME	Lesser Regeneration Potion
ITEM_LESSER_REGENERATION_POTION_DESCRIPTION	Temporarily regenerates 3 health over time.
ITEM_DEFENSE_POTION_NAME	Defense Potion
ITEM_DEFENSE_POTION_DESCRIPTION	Temporarily increases Defense by 10.
ITEM_EVASION_POTION_NAME	Evasion Potion
ITEM_EVASION_POTION_DESCRIPTION	Temporarily increases Evasion by 5%.
ITEM_MGK_DEFENSE_POTION_NAME	Mgk. Defense Potion
ITEM_MGK_DEFENSE_POTION_DESCRIPTION	Temporarily increases Magic Defense by 10.
ITEM_REGENERATION_POTION_NAME	Regeneration Potion
ITEM_REGENERATION_POTION_DESCRIPTION	Temporarily regenerates 8 health over time.
ITEM_TOME_OF_EXPERIENCE_NAME	Tome of Experience
ITEM_TOME_OF_EXPERIENCE_DESCRIPTION	The knowledge this Tome provides gives a sizable pile of experience to the reader.
ITEM_TOME_OF_GREATER_EXPERIENCE_NAME	Tome of Greater Experience
ITEM_TOME_OF_GREATER_EXPERIENCE_DESCRIPTION	The knowledge this Tome provides gives a massive pile of experience to the reader.
ITEM_TOME_OF_LESSER_EXPERIENCE_NAME	Tome of Lesser Experience
ITEM_TOME_OF_LESSER_EXPERIENCE_DESCRIPTION	The knowledge this Tome provides gives a handful of experience to the reader.
ITEM_TOME_OF_NAIVETY_NAME	Tome of Naivety
ITEM_TOME_OF_NAIVETY_DESCRIPTION	Reading this tome resets all of your Attributes, reimbursing your Attribute Points. <color=lime>Can only be used in a Safe Zone.</color>
ITEM_TOME_OF_UNLEARNING_NAME	Tome of Unlearning
ITEM_TOME_OF_UNLEARNING_DESCRIPTION	Reading this tome unlearns all your Skills, reimbursing all your spent Skill Points. <color=lime>Can only be used in a Safe Zone.</color>
ITEM_AGILITY_STONE_NAME	Agility Stone
ITEM_AGILITY_STONE_DESCRIPTION	Has capabilities to change a weapon damage scale to dexterity.
ITEM_ANGELAS_TEAR_NAME	Angela's Tear
ITEM_ANGELAS_TEAR_DESCRIPTION	Instantly revives the holder if they die.
ITEM_BLIGHTWOOD_LOG_NAME	Blightwood Log
ITEM_BLIGHTWOOD_LOG_DESCRIPTION	The inside is very hot, containing a burning blue flame that never seems to go out.
ITEM_BLIGHTWOOD_STICK_NAME	Blightwood Stick
ITEM_BLIGHTWOOD_STICK_DESCRIPTION	Feels warm to hold.
ITEM_BLUE_MINCHROOM_CAP_NAME	Blue Minchroom Cap
ITEM_BLUE_MINCHROOM_CAP_DESCRIPTION	The spores can frostbite something. Could be good to keep a room cool.
ITEM_BRONZE_ARROWS_NAME	Bronze Arrows
ITEM_BRONZE_ARROWS_DESCRIPTION	Ammunition for bows.
ITEM_CARBUNCLE_FOOT_NAME	Carbuncle Foot
ITEM_CARBUNCLE_FOOT_DESCRIPTION	The foot of a corrupted sage. The blood that drips from it quickly becomes a magical powder.
ITEM_CURSED_NOTE_NAME	Cursed Note
ITEM_CURSED_NOTE_DESCRIPTION	There are magic glyphs on this note. They seem to slowly float above the parchment.
ITEM_DEADWOOD_LOG_NAME	Deadwood Log
ITEM_DEADWOOD_LOG_DESCRIPTION	Hot orange energy eminates within this log.
ITEM_DEATHGEL_CORE_NAME	Deathgel Core
ITEM_DEATHGEL_CORE_DESCRIPTION	A chunk of a Deathgel.
ITEM_DIVA_NECKLACE_NAME	Diva Necklace
ITEM_DIVA_NECKLACE_DESCRIPTION	Too big to wear, though quite valuable.
ITEM_FLUX_STONE_NAME	Flux Stone
ITEM_FLUX_STONE_DESCRIPTION	Has capabilities to change a weapon damage scale to mind.
ITEM_GEIST_COLLAR_NAME	Geist Collar
ITEM_GEIST_COLLAR_DESCRIPTION	Shaking the bell doesn't make any noise.
ITEM_GHOSTDUST_NAME	Ghostdust
ITEM_GHOSTDUST_DESCRIPTION	Bottled spectral ashes of a restless ghost.
ITEM_GOLEM_CORE_NAME	Golem Core
ITEM_GOLEM_CORE_DESCRIPTION	The once functioning heart of a Golem. Quite heavy.
ITEM_GOLEM_GEM_NAME	Golem Gem
ITEM_GOLEM_GEM_DESCRIPTION	A red mist twists and turns within this gem.
ITEM_GREEN_LIPSTICK_NAME	Green Lipstick
ITEM_GREEN_LIPSTICK_DESCRIPTION	Tastes like sour apple candy.
ITEM_HELLSLUDGE_CORE_NAME	Hellsludge Core
ITEM_HELLSLUDGE_CORE_DESCRIPTION	A chunk of a Hellsludge.
ITEM_ILLUSION_STONE_NAME	Illusion Stone
ITEM_ILLUSION_STONE_DESCRIPTION	This magical stone can be used to change the appearance of things.
ITEM_MAW_EYE_NAME	Maw Eye
ITEM_MAW_EYE_DESCRIPTION	There's a glare of anxiety in the dilated pupil.
ITEM_MEKBOAR_HEAD_NAME	Mekboar Head
ITEM_MEKBOAR_HEAD_DESCRIPTION	The snout continues to pulse and wiggle around.
ITEM_MEKBOAR_SPEAR_NAME	Mekboar Spear
ITEM_MEKBOAR_SPEAR_DESCRIPTION	It is unknown how this spear was attached to a boar.
ITEM_MIGHT_STONE_NAME	Might Stone
ITEM_MIGHT_STONE_DESCRIPTION	Has capabilities to change a weapon damage scale to strength.
ITEM_MONOLITH_CORE_NAME	Monolith Core
ITEM_MONOLITH_CORE_DESCRIPTION	The heart of a Monolith. Dark green energy pulsates from within it.
ITEM_MONOLITH_GEM_NAME	Monolith Gem
ITEM_MONOLITH_GEM_DESCRIPTION	A hefty, green gem from a Monolith. Perhaps it is mutated.
ITEM_MOUTH_BITTERTOOTH_NAME	Mouth Bittertooth
ITEM_MOUTH_BITTERTOOTH_DESCRIPTION	The tip of the tooth endlessly drips a little bit of poison.
ITEM_MOUTH_EYE_NAME	Mouth Eye
ITEM_MOUTH_EYE_DESCRIPTION	Squishy. Though, it can't be popped.
ITEM_RAGEBOAR_HEAD_NAME	Rageboar Head
ITEM_RAGEBOAR_HEAD_DESCRIPTION	The eyes are bloodshot and filled with rage.
ITEM_RAGEBOAR_SPEAR_NAME	Rageboar Spear
ITEM_RAGEBOAR_SPEAR_DESCRIPTION	The bloodstain on this spear means deadly business.
ITEM_RED_MINCHROOM_CAP_NAME	Red Minchroom Cap
ITEM_RED_MINCHROOM_CAP_DESCRIPTION	The spores can set something on fire. Could be good to cook something spicy with.
ITEM_ROCK_NAME	Rock
ITEM_ROCK_DESCRIPTION	Just an ordinary rock. Could be tossed at enemies.
ITEM_SLIME_CORE_NAME	Slime Core
ITEM_SLIME_CORE_DESCRIPTION	A chunk of a Slime.
ITEM_SLIME_DIVA_EARS_NAME	Slime Diva Ears
ITEM_SLIME_DIVA_EARS_DESCRIPTION	Extremely large and long ears. Unlike other slime ears, these are not sharp to the touch, but rather soft.
ITEM_SLIME_EARS_NAME	Slime Ears
ITEM_SLIME_EARS_DESCRIPTION	These are somehow sharp on the ends, which can actually hurt.
ITEM_SLIMEK_CORE_NAME	Slimek Core
ITEM_SLIMEK_CORE_DESCRIPTION	A chunk of a Slimek.
ITEM_SLIMEK_EARS_NAME	Slimek Ears
ITEM_SLIMEK_EARS_DESCRIPTION	Even sharper than normal Slime ears.
ITEM_SLIMEK_EYE_NAME	Slimek Eye
ITEM_SLIMEK_EYE_DESCRIPTION	The swirly pupil rotates if you look at it long enough.
ITEM_SOUL_PEARL_NAME	Soul Pearl
ITEM_SOUL_PEARL_DESCRIPTION	Allows the holder to revive a fallen soul.\n<color=cyan>To revive someone, press the interact key when nearby them.</color>
ITEM_WIZBOAR_HEAD_NAME	Wizboar Head
ITEM_WIZBOAR_HEAD_DESCRIPTION	It's still smiling.
ITEM_WIZBOAR_SCEPTER_NAME	Wizboar Scepter
ITEM_WIZBOAR_SCEPTER_DESCRIPTION	Teeming with electricity. Too big of a weapon to use on your own.
CREEP_LESSER_WISP_NAME	Lesser Wisp
CREEP_LESSER_WISP_NAME_VARIANT_MANY	Lesser Wisps
CREEP_MIASMA_NAME	Miasma
CREEP_MIASMA_NAME_VARIANT_MANY	Miasmas
CREEP_GREATER_WISP_NAME	Greater Wisp
CREEP_GREATER_WISP_NAME_VARIANT_MANY	Greater Wisps
CREEP_TOXIN_NAME	Toxin
CREEP_TOXIN_NAME_VARIANT_MANY	Toxins
CREEP_ALSHAR_NAME	Alshar
CREEP_ALSHAR_NAME_VARIANT_MANY	Alshars
CREEP_CARBUNCLE_NAME	Carbuncle
CREEP_CARBUNCLE_NAME_VARIANT_MANY	Carbuncles
CREEP_STEZZA_NAME	Stezza
CREEP_STEZZA_NAME_VARIANT_MANY	Stezzas
CREEP_POLTERGEIST_NAME	Poltergeist
CREEP_POLTERGEIST_NAME_VARIANT_MANY	Poltergeists
CREEP_MINI_GEIST_NAME	Mini Geist
CREEP_MINI_GEIST_NAME_VARIANT_MANY	Mini Geists
CREEP_GEIST_NAME	Geist
CREEP_GEIST_NAME_VARIANT_MANY	Geists
CREEP_LORD_ZUULNERUDA_NAME	Lord Zuulneruda
CREEP_LORD_ZUULNERUDA_NAME_VARIANT_MANY	Lord Zuulnerudas
CREEP_LORD_KALUUZ_NAME	Lord Kaluuz
CREEP_LORD_KALUUZ_NAME_VARIANT_MANY	Lord Kaluuzs
CREEP_GOLEM_NAME	Golem
CREEP_GOLEM_NAME_VARIANT_MANY	Golems
CREEP_MONOLITH_NAME	Monolith
CREEP_MONOLITH_NAME_VARIANT_MANY	Monoliths
CREEP_DEMIGOLEM_NAME	Demigolem
CREEP_DEMIGOLEM_NAME_VARIANT_MANY	Demigolems
CREEP_COLOSSUS_NAME	Colossus
CREEP_COLOSSUS_NAME_VARIANT_MANY	Colossuss
CREEP_VALDUR_NAME	Valdur
CREEP_VALDUR_NAME_VARIANT_MANY	Valdurs
CREEP_MEKBOAR_NAME	Mekboar
CREEP_MEKBOAR_NAME_VARIANT_MANY	Mekboars
CREEP_BOOMBOAR_NAME	Boomboar
CREEP_BOOMBOAR_NAME_VARIANT_MANY	Boomboars
CREEP_RAGEBOAR_NAME	Rageboar
CREEP_RAGEBOAR_NAME_VARIANT_MANY	Rageboars
CREEP_WIZBOAR_NAME	Wizboar
CREEP_WIZBOAR_NAME_VARIANT_MANY	Wizboars
CREEP_BLUE_MINCHROOM_NAME	Blue Minchroom
CREEP_BLUE_MINCHROOM_NAME_VARIANT_MANY	Blue Minchrooms
CREEP_RED_MINCHROOM_NAME	Red Minchroom
CREEP_RED_MINCHROOM_NAME_VARIANT_MANY	Red Minchrooms
CREEP_YELLOW_MINCHROOM_NAME	Yellow Minchroom
CREEP_YELLOW_MINCHROOM_NAME_VARIANT_MANY	Yellow Minchrooms
CREEP_MINI_GOLEM_NAME	Mini Golem
CREEP_MINI_GOLEM_NAME_VARIANT_MANY	Mini Golems
CREEP_MOUTH_NAME	Mouth
CREEP_MOUTH_NAME_VARIANT_MANY	Mouths
CREEP_MAW_NAME	Maw
CREEP_MAW_NAME_VARIANT_MANY	Maws
CREEP_SLIME_NAME	Slime
CREEP_SLIME_NAME_VARIANT_MANY	Slimes
CREEP_HELLSLUDGE_NAME	Hellsludge
CREEP_HELLSLUDGE_NAME_VARIANT_MANY	Hellsludges
CREEP_TAR_SPAWN_NAME	Tar Spawn
CREEP_TAR_SPAWN_NAME_VARIANT_MANY	Tar Spawns
CREEP_SLIMEK_NAME	Slimek
CREEP_SLIMEK_NAME_VARIANT_MANY	Slimeks
CREEP_DEATHGEL_NAME	Deathgel
CREEP_DEATHGEL_NAME_VARIANT_MANY	Deathgels
CREEP_SLIME_DIVA_NAME	Slime Diva
CREEP_SLIME_DIVA_NAME_VARIANT_MANY	Slime Divas
CREEP_DEADWOOD_NAME	Deadwood
CREEP_DEADWOOD_NAME_VARIANT_MANY	Deadwoods
CREEP_BLIGHTWOOD_NAME	Blightwood
CREEP_BLIGHTWOOD_NAME_VARIANT_MANY	Blightwoods
CREEP_NOVICE_TRAINING_DUMMY_NAME	Novice Training Dummy
CREEP_NOVICE_TRAINING_DUMMY_NAME_VARIANT_MANY	Novice Training Dummys
CREEP_CLASS_TRAINING_DUMMY_NAME	Class Training Dummy
CREEP_CLASS_TRAINING_DUMMY_NAME_VARIANT_MANY	Class Training Dummys
QUEST_A_WARM_WELCOME_NAME	Una Calida bienvenida
QUEST_A_WARM_WELCOME_DESCRIPTION	Ah... Veo que estas listo, Y tu alma brilla mas que nunca. Porfavor, No temas. <color=cyan>Este lugar es tu hogar, nuestro hogar.</color>\n\nAntes de que empiezes en tu viaje, porfavor familiarizate con el santuario... <color=cyan>Despues de todo, Este es el ulitmo lugar seguro que tiene este mundo roto.</color>\n\n<color=yellow>Vuelve conmigo despues de que veas el portal del mundo, los cuarteles, la tienda, Y la entrada del santuario exterior.</color> \n\n<i>Y por supuesto, Tomate tu tiempo...</i>
QUEST_A_WARM_WELCOME_COMPLETE_RETURN_MESSAGE	Vuelve con angela al santuario
QUEST_TRIGGER_WORLDPORTALTRIGGER_PREFIX	Portal del mundo
QUEST_TRIGGER_WORLDPORTALTRIGGER_SUFFIX	Encontrado
QUEST_TRIGGER_SHOPDISCOVERTRIGGER_PREFIX	Tienda
QUEST_TRIGGER_SHOPDISCOVERTRIGGER_SUFFIX	Encontrado
QUEST_TRIGGER_GATEWAYDISCOVERTRIGGER_PREFIX	Entrada
QUEST_TRIGGER_GATEWAYDISCOVERTRIGGER_SUFFIX	Encontrado
QUEST_TRIGGER_BARRACKSDISCOVERTRIGGER_PREFIX	Cuarteles
QUEST_TRIGGER_BARRACKSDISCOVERTRIGGER_SUFFIX	Encontrado
QUEST_COMMUNING_CATACOMBS_NAME	Communing Catacombs
QUEST_COMMUNING_CATACOMBS_DESCRIPTION	It's quite dire, you see... the <color=cyan>Catacombs outside Sanctum</color> was a place I could commune my mystic energies with to survey the undead. What goes on there now has been all a mystery to me...\n\n<color=cyan>When the world shattered, so did my magic.</color> Fortunately, I can still feel the lost magic existing...\n\n<color=yellow>Find the stray Sigil deep within the Catacombs and let it tether to your soul.</color> Once you do, we can further explore what looms ahead of us... I do fear for the worst.
QUEST_COMMUNING_CATACOMBS_COMPLETE_RETURN_MESSAGE	Return to Angela in Sanctum.
QUEST_TRIGGER_SIGILTRIGGER_PREFIX	Sigil
QUEST_TRIGGER_SIGILTRIGGER_SUFFIX	attuned
QUEST_NIGHT_SPIRITS_NAME	Night Spirits
QUEST_NIGHT_SPIRITS_DESCRIPTION	<color=cyan>During the night,</color> the Wisps from the Catacombs nearby disturb the Outer Sanctum. Some Greater Wisps may also be found deeper within the Catacombs itself...\n\n<color=yellow>Abolish 8 Lesser Wisps and 5 Greater Wisps.</color>\nBe careful, because <color=cyan>Wisps can curse you...</color>
QUEST_NIGHT_SPIRITS_COMPLETE_RETURN_MESSAGE	Return to Angela in Sanctum.
QUEST_RIDDING_SLIMES_NAME	Ridding Slimes
QUEST_RIDDING_SLIMES_DESCRIPTION	The Slimes are quite the nuisance outside Sanctum... Fending them off would help us greatly.\n\n<color=cyan>Slimes are commonly found during the daytime.</color> <color=yellow>Gather 5 Slime Cores, 5 Slime Ears and kill 10 Slimes.</color> Come back safely...
QUEST_RIDDING_SLIMES_COMPLETE_RETURN_MESSAGE	Return to Angela in Sanctum.
QUEST_DISCIPLE_OF_MAGIC_NAME	Disciple of Magic
QUEST_DISCIPLE_OF_MAGIC_DESCRIPTION	Ah! There you are, little one. I've noticed that your skill has exceeded beyond where you began... <color=cyan>perhaps, you may be interested in embracing the studies of a Mystic?</color>\n\nIf you are sure to follow my warmth of wisdom and guidance, <color=yellow>I will bestow a tome that will bind my powers to you...</color> And of course, make your choice wisely, <color=yellow>as you cannot revert it.</color>\n\nHmm... O-Oh, yes! <color=yellow>If you happen to lose your tome while undecided, please talk to me again to retrieve another.</color> 
QUEST_DISCIPLE_OF_MAGIC_COMPLETE_RETURN_MESSAGE	Return to Angela in Sanctum.
QUEST_TRIGGER_GETMYSTICCLASS_PREFIX	Tome of the Mystic
QUEST_TRIGGER_GETMYSTICCLASS_SUFFIX	read
QUEST_MASTERY_OF_BELLS_NAME	Mastery of Bells
QUEST_MASTERY_OF_BELLS_DESCRIPTION	Have you used Magic Bells before, little one? They are quite mysterious... well, they <i>were</i> mysterious. Fortunately for us, <color=cyan>I have uncovered the secrets to use them at their maximum power!</color>\n\n\n<color=yellow>Take this scroll. Reading it will teach you to charge and release powerful magic beyond comprehension...</color>\n\n<color=yellow>Ah, right... in any case if your mind changes, return to me, and I can provide to you as many scrolls as you need... Keep in mind, the skill scroll will vanish if you drop it.</color>
QUEST_MASTERY_OF_BELLS_COMPLETE_RETURN_MESSAGE	Return to Angela in Sanctum.
QUEST_TRIGGER_USEBELLSCROLL_PREFIX	Bell Mastery Scroll
QUEST_TRIGGER_USEBELLSCROLL_SUFFIX	read
QUEST_MASTERY_OF_SCEPTERS_NAME	Mastery of Scepters
QUEST_MASTERY_OF_SCEPTERS_DESCRIPTION	After many years of intensive studying, <color=cyan>I have uncovered the secrets of utilizing Magic Scepters!</color> Little one, would you be interested in learning them as well? <color=yellow>If so, I can provide you this skill scroll.</color> \n\n\n<color=cyan>Use it, and you will understand how to sharpen your mind to such weapons...</color>\n\n<color=yellow>Oh yes, if you change your mind, return to me, and I can provide to you as many scrolls as you need... Keep in mind, the skill scroll will vanish if you drop it.</color>\n
QUEST_MASTERY_OF_SCEPTERS_COMPLETE_RETURN_MESSAGE	Return to Angela in Sanctum.
QUEST_TRIGGER_USESCEPTERSCROLL_PREFIX	Scepter Mastery Scroll
QUEST_TRIGGER_USESCEPTERSCROLL_SUFFIX	read
QUEST_THE_KEEP_WITHIN_NAME	The Keep Within
QUEST_THE_KEEP_WITHIN_DESCRIPTION	The world is healing, little one... We must see what lies futher beyond and press on. <color=cyan>If memory serves, there is a portal in the Effold Terrace leading to an Ancient Keep. Within the east and west wing chambers, there are sigils that must be attuned to your soul.</color> Please be prepared for what may dwell there...
QUEST_THE_KEEP_WITHIN_COMPLETE_RETURN_MESSAGE	Return to Angela in Sanctum.
QUEST_TRIGGER_SIGILTRIGGER_00_PREFIX	West Wing Sigil
QUEST_TRIGGER_SIGILTRIGGER_00_SUFFIX	attuned
QUEST_TRIGGER_SIGILTRIGGER_01_PREFIX	East Wing Sigil
QUEST_TRIGGER_SIGILTRIGGER_01_SUFFIX	attuned
QUEST_ANCIENT_BEINGS_NAME	Ancient Beings
QUEST_ANCIENT_BEINGS_DESCRIPTION	It's concerning, little one. <color=cyan>There are droves of ancient Golems roaming around Crescent Keep,</color> and they are quite hostile... \n\nThe Golems were once peaceful constructs that fended off monsters, but now they have turned to aid them instead. <color=cyan>I can only assume that the shattering of the world caused this, and the gems held in their heads drove them into madness...</color> Either way, I must study this matter. \n\n<color=yellow>Defeat 15 Golems small and large, and collect 15 of their gems.</color> A reward for your troubles will be in order...
QUEST_ANCIENT_BEINGS_COMPLETE_RETURN_MESSAGE	Return to Angela in Sanctum.
QUEST_CONSUMED_MADNESS_NAME	Consumed Madness
QUEST_CONSUMED_MADNESS_DESCRIPTION	The Sanctum Catacombs isn't what you remember, little one... In fact, <color=cyan>the true incantation of the Catacombs is open for us to see, and it's quite dire.</color> I understand that you may have been through so much, but <i>I know</i> that you can do this!\n\nThe only way to keep the Catacombs from getting worse, <color=yellow>is to satiate the madness by defeating the forces of undead in it's worst form...</color>\n\nPlease return to me once you have done this task... <color=cyan>I greatly urge you to bring healing items with you in this journey!</color>
QUEST_CONSUMED_MADNESS_COMPLETE_RETURN_MESSAGE	Return to Angela in Sanctum.
QUEST_TRIGGER_SWEEPFINISHHARD_PREFIX	Catacombs
QUEST_TRIGGER_SWEEPFINISHHARD_SUFFIX	Cleared (lv12-18)
QUEST_SPIRALING_IN_THE_GROVE_NAME	Spiraling In The Grove
QUEST_SPIRALING_IN_THE_GROVE_DESCRIPTION	<color=cyan>The Crescent Grove is teeming with corruption...</color> As sad as it is to see how it's turned this way, it must be held back from getting worse. \n\n<color=cyan>I know that you are more than capable to provide the purification to this corrupted grove, little one.</color>\n\n<color=yellow>From the beginning to the end of the Crescent Grove, slay all the monsters that dwell within it.</color> As you know, they reside in the hazy dark magic, and only appear when you come near them. \n\n<color=cyan>Return to me once you have swept the grove from evil, and I will bestow a reward to you...</color>\n
QUEST_SPIRALING_IN_THE_GROVE_COMPLETE_RETURN_MESSAGE	Return to Angela in Sanctum.
QUEST_TRIGGER_SWEEPFINISHGROVENORMAL_PREFIX	Crescent Grove
QUEST_TRIGGER_SWEEPFINISHGROVENORMAL_SUFFIX	Cleared (lv15-20)
QUEST_TETHERING_GROVE_NAME	Tethering Grove
QUEST_TETHERING_GROVE_DESCRIPTION	Since ancient times, the Crescent Keep was held in high regard amongst our kind for generations... \n\n<color=cyan>When the world shattered, the cause of the Crescent Keep's demise was from an unfathomable corruption.</color> The souls from other worlds who settled there did not live as long as they hoped, and the druids of our kind became corrupt abominations.\n\n<color=yellow>You can find the Crescent Grove deep in the Crescent Keep, at the East wing. A door should open once you're near it. Find the stray sigil in the Crescent Grove, and tether it to your soul.</color> The monsters that lurk the grove are mighty! Please be prepared, little one.\n
QUEST_TETHERING_GROVE_COMPLETE_RETURN_MESSAGE	Return to Angela in Sanctum.
QUEST_TRIGGER_GROVESIGILTRIGGER_PREFIX	Crescent Grove Sigil
QUEST_TRIGGER_GROVESIGILTRIGGER_SUFFIX	Attuned
QUEST_THE_EFFOLD_TERRACE_NAME	The Effold Terrace
QUEST_THE_EFFOLD_TERRACE_DESCRIPTION	Slimes ambushed you in the Catacombs? Well then... it's possible that I can quickly piece this issue together.\n\nWith the ward restored by your lovely soul, the portal leading to the Effold Terrace should be open to you now.\n\n<color=cyan>The portal is located northeast of the Catacombs entrance.</color> From what I see in the Terrace, it's infested with filthy Slimeks. Unlike ordinary slimes, they are stronger and infused with tar.\n\n<color=yellow>Slay 15 Slimeks, then return to me safely...</color>
QUEST_THE_EFFOLD_TERRACE_COMPLETE_RETURN_MESSAGE	Return to Angela in Sanctum.
QUEST_CLEANING_TERRACE_NAME	Cleaning Terrace
QUEST_CLEANING_TERRACE_DESCRIPTION	Hmph, those nasty Slimeks don't seem to quit. The <color=cyan>Effold Terrace</color> could benefit by some immediate cleanup... \n\nPerhaps you could do me a favor and show them a little force of your skill? <color=yellow>Slay about 20 Slimeks,</color> and return to me when you can...
QUEST_CLEANING_TERRACE_COMPLETE_RETURN_MESSAGE	Return to Angela in Sanctum.
QUEST_DIVA_MUST_DIE_NAME	Diva Must Die
QUEST_DIVA_MUST_DIE_DESCRIPTION	It looks like you have done a great deal of damage to the Queen's hive of Slimeks... By proving your strength against her deluded offense, it's time to take her on while the iron is still hot.\n\nFrom what the ley energies that surround the Terrace suggest, <color=cyan>the Queen would appear if her children continued to die...</color>\n\nPerhaps where there are more Slimeks, that is where she may be hidden. I trust that you can fend her off and teach her a lesson, hm?
QUEST_DIVA_MUST_DIE_COMPLETE_RETURN_MESSAGE	Return to Angela in Sanctum.
QUEST_RATTLECAGE_RAGE_NAME	Rattlecage Rage
QUEST_RATTLECAGE_RAGE_DESCRIPTION	Hm... oh! I understand that the Catacombs may have been challenging to you, yes? O-Oh...? No? Well... in case if you didn't know, it seems as though the Catacombs shifts its form each time you enter. <color=cyan>The portal leading into them is corrupted, always changing what happens within.</color>\n\n<i>I know you're up to the task, little one...</i>\n\n<color=yellow>Sweep out the evil that resides inside the Catacombs, from the start to the end.</color> Return to me once you have done this challenge <color=yellow>normally...</color> and of course, please be safe.
QUEST_RATTLECAGE_RAGE_COMPLETE_RETURN_MESSAGE	Return to Angela in Sanctum.
QUEST_TRIGGER_SWEEPFINISH_PREFIX	Catacombs
QUEST_TRIGGER_SWEEPFINISH_SUFFIX	Cleared (lv6-12)
QUEST_HUNTIN_HOGS_NAME	Huntin' Hogs
QUEST_HUNTIN_HOGS_DESCRIPTION	Your soul is as strong as ever, little one. Why don't we try something a little more... well, <i>daring?</i>\n\n<color=cyan>There is a small passage tucked away within the Outer Sanctum,</color> swarming with awful creatures known as Mekboars. They brand devastating weapons on their heads, looking to pick a fight with anyone who treads on their turf... \n\nIf you would, <color=yellow>display your skill by slaying 20 Mekboars and gather 15 of their spears.</color>\n\nReturn to me when you have...
QUEST_HUNTIN_HOGS_COMPLETE_RETURN_MESSAGE	Return to Angela in Sanctum.
QUEST_KILLING_TOMB_NAME	Killing Tomb
QUEST_KILLING_TOMB_DESCRIPTION	You'll soon be bearing witness to an atrocity, lost one. <color=cyan>The Sanctum Catacombs nearby have been stirring up noise for a while now.</color> I do not have the time or patience to put up with their nonsense. \n\nThis is your first challenge to prove your worth to this world. <color=yellow>Make haste to the Catacombs, and slay 10 Mini Geists alongside 2 Geists.</color> I will see that you will be worthy for the further tasks ahead once you have done this test. \n\n<color=cyan>Speak to Angela for further instructions if you haven't done so. Without her assistance, you will not gain entry to the Catacombs.</color>\n
QUEST_KILLING_TOMB_COMPLETE_RETURN_MESSAGE	Return to Enok in Sanctum.
QUEST_MASTERY_OF_BLADES_NAME	Mastery of Blades
QUEST_MASTERY_OF_BLADES_DESCRIPTION	You seem to be using your strength rather well, lost one. <color=yellow>Take this scroll.</color> <color=cyan>Reading it will allow you to bolster your power using one-handed melee weapons.</color> Focus well, and you will be able to charge attack and jump attack against your enemies with devastating force.\n\n<color=yellow>Come back to me anytime if you reconsider your choice. I will provide as many scrolls as you need. Remember that your scroll will vanish if you lose it.</color>
QUEST_MASTERY_OF_BLADES_COMPLETE_RETURN_MESSAGE	Return to Enok in Sanctum.
QUEST_TRIGGER_USEMELEESCROLL_PREFIX	Melee Mastery Scroll
QUEST_TRIGGER_USEMELEESCROLL_SUFFIX	read
QUEST_MASTERY_OF_HAMMERS_NAME	Mastery of Hammers
QUEST_MASTERY_OF_HAMMERS_DESCRIPTION	<color=cyan>It takes immense strength to use heavy weapons, lost one.</color> I see that you have potential in using them. <color=yellow>If you think you can handle this burden of war, take this scroll.</color> <color=cyan>Reading it will teach you what there is to know in smashing your foes into bloody pieces.</color>\n\n<color=yellow>Come back to me anytime if you reconsider your choice. I will provide as many scrolls as you need. Remember that your scroll will vanish if you lose it.</color>
QUEST_MASTERY_OF_HAMMERS_COMPLETE_RETURN_MESSAGE	Return to Enok in Sanctum.
QUEST_TRIGGER_USEHEAVYMELEESCROLL_PREFIX	H. Melee Mastery Scroll
QUEST_TRIGGER_USEHEAVYMELEESCROLL_SUFFIX	read
QUEST_MASTERY_OF_SPEARS_NAME	Mastery of Spears
QUEST_MASTERY_OF_SPEARS_DESCRIPTION	Polearms bring me back to a nostalgic time of training. Much like other melee weapons, <color=cyan>they are viable tools of war.</color> I see a spark in your eye, lost one. <color=yellow>Take this scroll, as it will teach you to apply higher skill to your use of polearms.</color>\n\n<color=yellow>Come back to me anytime if you reconsider your choice. I will provide as many scrolls as you need. Remember that your scroll will vanish if you lose it.</color>
QUEST_MASTERY_OF_SPEARS_COMPLETE_RETURN_MESSAGE	Return to Enok in Sanctum.
QUEST_TRIGGER_USEPOLEARMSCROLL_PREFIX	Polearm Mastery Scroll
QUEST_TRIGGER_USEPOLEARMSCROLL_SUFFIX	read
QUEST_STRENGTH_AND_HONOR_NAME	Strength and Honor
QUEST_STRENGTH_AND_HONOR_DESCRIPTION	The time has come to make the ultimate decision, lost one. I see that the strength and skill you have gathered has been more than sufficent <color=cyan>to bring forth your true colors of becoming a Fighter.</color>\n\nBecoming a Fighter will make you a living threat against the evil monstrosities that coat this world. <color=yellow>Take this tome.</color> Once read, you will join me in our effort to divide the darkness.\n\n<color=yellow>If you happen to lose your tome undecided, return to me. I can provide as many as you need.</color> <color=cyan>Keep in mind, reading this tome is irreversible.</color>
QUEST_STRENGTH_AND_HONOR_COMPLETE_RETURN_MESSAGE	Return to Enok in Sanctum.
QUEST_TRIGGER_GETFIGHTERCLASS_PREFIX	Tome of the Fighter
QUEST_TRIGGER_GETFIGHTERCLASS_SUFFIX	read
QUEST_ERADICATING_THE_UNDEAD_NAME	Eradicating the Undead
QUEST_ERADICATING_THE_UNDEAD_DESCRIPTION	The time is now, lost one. <color=cyan>The Sanctum Catacombs finally uncovered its true self, and the moment to strike where the undead least expect it is here.</color> As foolish and aimless as they are, the undead in this incantation are ruthless in their power.\n\nThese monstrosities must be stopped before they aim to further corrupt our land. <color=yellow>Slay 15 Miasma, 10 Hellsludge, and 20 Poltergeists. You can find them in the hardest Sanctum Catacombs.</color> Let the undead suffer our wrath, no survivors.\n
QUEST_ERADICATING_THE_UNDEAD_COMPLETE_RETURN_MESSAGE	Return to Enok in Sanctum.
QUEST_PURGING_THE_GROVE_NAME	Purging the Grove
QUEST_PURGING_THE_GROVE_DESCRIPTION	<color=cyan>The Crescent Grove is a malice to this world.</color> The creatures that swarm within the grove are not up to snuff to our standards, lost one. Silence them, and put their corrupted minds to rest.\n\n<color=yellow>Destroy 20 Deadwoods, 10 Carbuncles, 10 Red and Blue Minchrooms, and 15 Monoliths.</color> Return to me at once when your task is completed.\n
QUEST_PURGING_THE_GROVE_COMPLETE_RETURN_MESSAGE	Return to Enok in Sanctum.
QUEST_REVILING_THE_RAGEBOARS_NAME	Reviling the Rageboars
QUEST_REVILING_THE_RAGEBOARS_DESCRIPTION	The Rageboars in Tuul Valley are cowards. To think they can stand a chance against us is laughable.\n\n<color=cyan>Deep in the Valley is a temple, overrun with the damn things.</color> These devious boars were constructed by an ominous evil being that has no remorse for this world. We will discuss of her when your time is ready, lost one. For now, we must focus on what you can handle.\n\n<color=yellow>Slay 20 Rageboars. They are hidden within the temple I have spoken of, in Tuul Valley.</color> Be advised that going deep in the temple can get you killed if you're not careful.\n
QUEST_REVILING_THE_RAGEBOARS_COMPLETE_RETURN_MESSAGE	Return to Enok in Sanctum.
QUEST_THE_COLOSSUS_NAME	The Colossus
QUEST_THE_COLOSSUS_DESCRIPTION	I see that you have aligned yourself well against the foes in Crescent Keep. Good work, lost one. <color=cyan>It is time now to take a step further beyond the Keep, to the Crescent Grove.</color> What you will witness there is a foul swarm of dark magics, with many of our fallen kind from ages past embracing the corruption.\n\nThere are two brothers, whom I was once familiar with. They are now wicked Carbuncles, meeting the same fate the others have. <color=cyan>The brothers created a golem, one that is capable of tearing the world asunder.</color> We must put an end to their cowardice. <color=yellow>Destroy the Colossus, then return to me.</color>\n\n<color=yellow>If you haven't done so, speak to Angela. She can guide you to the Crescent Grove.</color>\n
QUEST_THE_COLOSSUS_COMPLETE_RETURN_MESSAGE	Return to Enok in Sanctum.
QUEST_PURGING_THE_UNDEAD_NAME	Purging the Undead
QUEST_PURGING_THE_UNDEAD_DESCRIPTION	<color=cyan>The Sanctum Catacombs is a never ending hellscape, driven in a goal to bring Sanctum to its knees.</color> Fortunately for us, they're too stupid to realize who they're dealing with. The amount of patience I have with these pathetic creatures is running thin.\n\n<color=cyan>With the privledge of my strength imbued with your soul, we can make the undead scream in agony together.</color> <color=yellow>Slay 15 Toxins, 10 Deathgels, and 20 Geists. You can find them in the normal Sanctum Catacombs.</color> This should be a humourous reminder for the undead to know exactly who controls this land.\n
QUEST_PURGING_THE_UNDEAD_COMPLETE_RETURN_MESSAGE	Return to Enok in Sanctum.
QUEST_THE_VOICE_OF_ZUULNERUDA_NAME	The Voice of Zuulneruda
QUEST_THE_VOICE_OF_ZUULNERUDA_DESCRIPTION	Listen. <i>Do you hear it?</i> There's a faint sound of laughter in the distance, coming from the Catacombs. <color=cyan>Within it is an entity that is the manifestation that continues to reanimate the dead.</color>\n\n<color=cyan>This entity is named Lord Zuulneruda.</color> A "Geistlord", one of the higher elites in the undead ranks. He must be purged. <color=yellow>Seek Zuulneruda, and kill him. He is hidden within the medium layer of the corrupted portal.</color>\n\nHurry, lost one... time is of the essence. <color=yellow>Return to me when his blood is in your hands.</color>\n\n<color=cyan>[Defeat Lord Zuulneruda in the (LV6-12) Sanctum Catacombs.]</color>
QUEST_THE_VOICE_OF_ZUULNERUDA_COMPLETE_RETURN_MESSAGE	Return to Enok in Sanctum.
QUEST_GHOSTLY_GOODS_NAME	Ghostly Goods
QUEST_GHOSTLY_GOODS_DESCRIPTION	Y'know, I could use somethin' of your help, if ya don't mind! <color=cyan>If you're up to it, I'll let you in on a secret too-- but keep it on the hush hush!</color>\n\nI'm lookin' for a special combination of ghostly goods, <color=cyan>the type that can be mixed into a fine lil' powder that makes you invisible!</color> \n\nIf ya could, <color=yellow>fetch me some Ghostdusts from them undead fellas, and a handful of those weird lil' collars the Geists wear from the Catacombs!</color>\n\nCome back when ya got a good amount of em', ya hear?\n\n<color=cyan>Oh! Make sure ya speak to Angela before ya head on over' there! She can open the way into the Catacombs real easy!</color>\n
QUEST_GHOSTLY_GOODS_COMPLETE_RETURN_MESSAGE	Return to Sally in Sanctum.
QUEST_SUMMORE_SPECTRAL_POWDER_NAME	Summore' Spectral Powder!
QUEST_SUMMORE_SPECTRAL_POWDER_DESCRIPTION	Mmm-hm! What'd ya think of that powder, hun? Pretty nifty, <i>right?</i>\n\nSay, if ya want summore, how bout' you fetch some Ghostdust and Geist Collars? I won't be needin' as many as before. <color=cyan>Keepin' mind-- the Sanctum Catacombs is the best place to get the stuff!</color>\n\n<color=yellow>Bring me... about 20 Ghostdusts and 8 Geist Collars,</color> and I'll whip up nother' batch for ya! <i>I'll make it bigger too.</i>
QUEST_SUMMORE_SPECTRAL_POWDER_COMPLETE_RETURN_MESSAGE	Return to Sally in Sanctum.
QUEST_DEVIOUS_PACT_NAME	Devious Pact
QUEST_DEVIOUS_PACT_DESCRIPTION	Well look at that! Haven't ya been busy? <color=cyan>I've been meanin' to let ya in on somethin', but it'll only be between us and a spare few!</color>\n\nI take it ya like shiny things-- coins and loot? Or maybe disorienting your foes? I can help ya with that... <color=cyan>Believe it or not, I am the Bandit Guardian!</color> We all work hard for our business, <i>even if it takes certain methods to get our way.</i>\n\n<color=yellow>Take this, and consider joining me and my crew! Keepin' mind ya can't revert your choice. If ya lose your tome, come back again!</color>
QUEST_DEVIOUS_PACT_COMPLETE_RETURN_MESSAGE	Return to Sally in Sanctum.
QUEST_TRIGGER_GETBANDITCLASS_PREFIX	Tome of the Bandit
QUEST_TRIGGER_GETBANDITCLASS_SUFFIX	read
QUEST_MAKIN_A_VILE_BLADE_NAME	Makin' a Vile Blade
QUEST_MAKIN_A_VILE_BLADE_DESCRIPTION	<color=cyan>You've been at the Crescent Keep, right?</color> Last I've heard, that place is swarmin' with those lil' halitosis-ridden critters! We're not sure what to call em', <color=cyan>so we just call em' Mouths to keep things simple.</color>\n\nMaybe we can make somethin' just to give them a taste of their own breath! <color=yellow>Bring me a Rude Blade, 5 Mouth Bitterteeth, 3 Slimek Eyes, and 10 Deathgel Cores!</color> We'll make that blade as vile as they are, hun!\n\n<color=cyan>You can find a Rude Blade in the Crescent Keep, Slimeks in the Effold Terrace, and Deathgels in the normal Sanctum Catacombs!</color>\n\n
QUEST_MAKIN_A_VILE_BLADE_COMPLETE_RETURN_MESSAGE	Return to Sally in Sanctum.
QUEST_MAKIN_A_WIZWAND_NAME	Makin' a Wizwand
QUEST_MAKIN_A_WIZWAND_DESCRIPTION	<color=cyan>Ya ever see those strange Wizboars, hun?</color> Those fellas always look so happy. Believe me though, they're vicious lil' things!\n\nMaybe we can build a smaller, but easier to use scepter that functions like one of theirs, yeah? <color=yellow>Bring me 1 Wizboar Scepter, 5 Blightwood Sticks and 5 Blightwood Logs!</color> Ya up to it?\n
QUEST_MAKIN_A_WIZWAND_COMPLETE_RETURN_MESSAGE	Return to Sally in Sanctum.
QUEST_MAKIN_MORE_VILE_BLADES_NAME	Makin' More Vile Blades
QUEST_MAKIN_MORE_VILE_BLADES_DESCRIPTION	<color=cyan>Ready to make another Vile Blade?</color> Alright!\n\n<color=yellow>Bring me a Rude Blade, 5 Mouth Bitterteeth, 3 Slimek Eyes, and 10 Deathgel Cores!</color>\n\n<color=cyan>You can find a Rude Blade in the Crescent Keep, Slimeks in the Effold Terrace, and Deathgels in the normal Sanctum Catacombs!</color>\n\n
QUEST_MAKIN_MORE_VILE_BLADES_COMPLETE_RETURN_MESSAGE	Return to Sally in Sanctum.
QUEST_MAKIN_MORE_WIZWANDS_NAME	Makin' More Wizwands
QUEST_MAKIN_MORE_WIZWANDS_DESCRIPTION	<color=cyan>Interested in makin' another Wizwand?</color> We can do that! It'll take the same amount of stuff, <i>juust</i> lettin' ya know.\n\n<color=yellow>Bring me 1 Wizboar Scepter, 5 Blightwood Sticks and 5 Blightwood Logs!</color> We'll get ya covered.\n\n
QUEST_MAKIN_MORE_WIZWANDS_COMPLETE_RETURN_MESSAGE	Return to Sally in Sanctum.
QUEST_MASTERY_OF_KATARS_NAME	Mastery of Katars
QUEST_MASTERY_OF_KATARS_DESCRIPTION	Hm! Well wouldn't ya know? I didn't think' I'd be offering such a thing, but I'll let you in on it. \n\nWay back then, I was always fightin' to dominate in the business, makin' sure things were gettin' taken care of. <color=cyan>In that time, I used special techniques usin' katars!</color> Sharp lil' things, able to slice and knock out competition in a heartbeat!\n\nIf you'd be interested in knowing some of that skill, I can teach ya! <color=yellow>Take this scroll. It'll give ya the boost you'd need to pummel them runts into the dirt!</color>\n\n<color=yellow>In case ya wanna think' it over twice, I'm always here to give another scroll if ya need it! Just know that the scroll will vanish if ya drop it, ya hear?</color>
QUEST_MASTERY_OF_KATARS_COMPLETE_RETURN_MESSAGE	Return to Sally in Sanctum.
QUEST_TRIGGER_USEKATARSCROLL_PREFIX	Katar Mastery Scroll
QUEST_TRIGGER_USEKATARSCROLL_SUFFIX	read
QUEST_MASTERY_OF_RANGE_NAME	Mastery of Range
QUEST_MASTERY_OF_RANGE_DESCRIPTION	<color=cyan>Ever thought you'd be interested in the know-how on usin' ranged weapons?</color> It may come as a shock to you hun, but I know my way around usin' em and takin' down things when the job needs to be done! Ranged weapons have been a lifesaver for me and my crew!\n\nIf you'd be interested in knowing some of that skill, I can teach ya! <color=yellow>Take this scroll. Learnin' it can give you the ability to use ranged weapons at their best potential!</color>\n\n<color=yellow>In case ya wanna think' it over twice, I'm always here to give another scroll if ya need it! Just know that the scroll will vanish if ya drop it, ya hear?</color>
QUEST_MASTERY_OF_RANGE_COMPLETE_RETURN_MESSAGE	Return to Sally in Sanctum.
QUEST_TRIGGER_USERANGEDSCROLL_PREFIX	Ranged Mastery Scroll
QUEST_TRIGGER_USERANGEDSCROLL_SUFFIX	read
QUEST_MAKIN_A_GOLEM_CHESTPIECE_NAME	Makin' a Golem Chestpiece
QUEST_MAKIN_A_GOLEM_CHESTPIECE_DESCRIPTION	<color=cyan>Them Golems in Crescent Keep are strong buggers!</color> Maybe we can take their cores and gems, make somethin' neat outta it! It'd be a chestpiece, a pretty strong one too!\n\n<color=yellow>Bring on over 10 Golem Cores, and 15 Golem Gems,</color> and we'll get that chestpiece made!\n
QUEST_MAKIN_A_GOLEM_CHESTPIECE_COMPLETE_RETURN_MESSAGE	Return to Sally in Sanctum.
QUEST_SUMMORE_GOLEM_CHESTPIECES_NAME	Summore' Golem Chestpieces
QUEST_SUMMORE_GOLEM_CHESTPIECES_DESCRIPTION	Oh? <color=cyan>Lookin' to make another Golem Chestpiece?</color> I'm gonna be needin' the same materials for it then, hun!\n\n<color=yellow>Bring on over 10 Golem Cores and 15 Golem Gems,</color> and we'll get that chestpiece made!\n
QUEST_SUMMORE_GOLEM_CHESTPIECES_COMPLETE_RETURN_MESSAGE	Return to Sally in Sanctum.
QUEST_MAKIN_A_RAGESPEAR_NAME	Makin' a Ragespear
QUEST_MAKIN_A_RAGESPEAR_DESCRIPTION	Hm, yep! Ya made a Mekspear before, I remember! <color=cyan>Wanna take it to the next level? Y'know, we could...</color>\n\n<color=yellow>Head on over to Tuul Valley, and wrangle them Rageboars for one of their spears!</color> They're a lil' tougher than what you've fought before, so stay focused, hun!\n\n<color=yellow>I'll need some hellsludge cores too, bout' 15 of them, to keep it all together. They're from them Hellsludges in the hardest Sanctum Catacombs. Make sure ya got a Mekspear on hand too!</color>
QUEST_MAKIN_A_RAGESPEAR_COMPLETE_RETURN_MESSAGE	Return to Sally in Sanctum.
QUEST_MAKIN_MORE_RAGESPEARS_NAME	Makin' More Ragespears
QUEST_MAKIN_MORE_RAGESPEARS_DESCRIPTION	<color=cyan>Lookin' to make another Ragespear, hun?</color> Alright! Here's what we're gonna' need:\n\n<color=yellow>1 Mekspear, 1 Rageboar Spear, and 15 Hellsludge Cores!</color>\n\n<color=cyan>Ya can find them Rageboars in Tuul Valley, and Hellsludges in the hardest Sanctum Catacombs.</color> Goodluck!
QUEST_MAKIN_MORE_RAGESPEARS_COMPLETE_RETURN_MESSAGE	Return to Sally in Sanctum.
QUEST_MAKIN_A_MONOLITH_CHESTPIECE_NAME	Makin' a Monolith Chestpiece
QUEST_MAKIN_A_MONOLITH_CHESTPIECE_DESCRIPTION	<color=cyan>Still got that lil' Golem Chestpiece we made a while back?</color> Lemme tell ya, there's a way to make it <i>even better!</i>\n\n<color=cyan>In the Crescent Grove, there's a much, much stronger type of Golem that dwells there.</color> They are some real nasty buggers!\n\nLet's make a strong chestpiece outta their materials! <color=yellow>Bring me... a Golem Chestpiece, 15 Monolith Cores,  10 Monolith Gems, and lastly, 5 Cursed Notes from them Carbuncles in the Grove!</color>\n\n<i>Whaddya say?</i>\n
QUEST_MAKIN_A_MONOLITH_CHESTPIECE_COMPLETE_RETURN_MESSAGE	Return to Sally in Sanctum.
QUEST_SUMMORE_MONOLITH_CHESTPIECES_NAME	Summore' Monolith Chestpieces
QUEST_SUMMORE_MONOLITH_CHESTPIECES_DESCRIPTION	Ah! Lookin' for another Monolith Chestpiece, hm? Okay! Here's what we'll need for it:\n\n <color=yellow>Bring me... a Golem Chestpiece, 15 Monolith Cores,  10 Monolith Gems, and lastly, 5 Cursed Notes from them Carbuncles in the Grove!</color>\n\n<i>Whaddya say?</i>\n
QUEST_SUMMORE_MONOLITH_CHESTPIECES_COMPLETE_RETURN_MESSAGE	Return to Sally in Sanctum.
QUEST_MAKIN_A_MEKSPEAR_NAME	Makin' a Mekspear
QUEST_MAKIN_A_MEKSPEAR_DESCRIPTION	Heya hun'! <color=cyan>I've been thinkin' of somethin we could make. Perhaps somethin' like a powerful spear!</color> Y'know, them Mekboars look like they got somethin fierce with them spears on their lil' heads.\n\nHow bout this, give me... say, <color=yellow>1 spear from them Mekboars, and 15 Slimek Cores to keep it all together.</color> I'll make a nice partisan for ya in return. Sound good?\n\t
QUEST_MAKIN_A_MEKSPEAR_COMPLETE_RETURN_MESSAGE	Return to Sally in Sanctum.
QUEST_MAKIN_MORE_MEKSPEARS_NAME	Makin' More Mekspears
QUEST_MAKIN_MORE_MEKSPEARS_DESCRIPTION	<color=cyan>Lookin' to make another Mekspear?</color> Well, alright then!\n\nY'know the drill! I'll need... <color=yellow>1 spear from them Mekboars and 15 Slimek Cores to keep it together,</color> and I'll make a nice partisan for ya in return. Sound good?\n
QUEST_MAKIN_MORE_MEKSPEARS_COMPLETE_RETURN_MESSAGE	Return to Sally in Sanctum.
CONDITION_BURN_NAME	Burn
CONDITION_BURN_1_DESCRIPTION	Burning.
CONDITION_COLD_NAME	Cold
CONDITION_COLD_1_DESCRIPTION	Snared.
CONDITION_GASH_NAME	Gash
CONDITION_GASH_1_DESCRIPTION	Bleeding 3 damage every 0.4 sec.
CONDITION_POISON_NAME	Poison
CONDITION_POISON_1_DESCRIPTION	Poisoned.
CONDITION_VILEBLADE_POISON_NAME	Vileblade Poison
CONDITION_VILEBLADE_POISON_1_DESCRIPTION	Poisoned.
CONDITION_WEAKENING_NAME	Weakening
CONDITION_WEAKENING_0_DESCRIPTION	Defense lowered by 5.
CONDITION_CYRO_SLOW_NAME	Cyro Slow
CONDITION_CYRO_SLOW_0_DESCRIPTION	Cold. Movement slowed down.
CONDITION_DEFENSE_POTION_NAME	Defense Potion
CONDITION_DEFENSE_POTION_0_DESCRIPTION	Defense increased by 5.
CONDITION_DEFENSE_POTION_1_DESCRIPTION	Defense increased by 10.
CONDITION_EVASION_POTION_NAME	Evasion Potion
CONDITION_EVASION_POTION_0_DESCRIPTION	Evasion increased by 3%.
CONDITION_EVASION_POTION_1_DESCRIPTION	Evasion increased by 5%.
CONDITION_EVASION_POTION_2_DESCRIPTION	Evasion increased by 7%.
CONDITION_MGK_DEFENSE_POTION_NAME	Mgk. Defense Potion
CONDITION_MGK_DEFENSE_POTION_0_DESCRIPTION	Magic Defense increased by 5.
CONDITION_MGK_DEFENSE_POTION_1_DESCRIPTION	Magic Defense increased by 10.
CONDITION_REGENERATION_POTION_NAME	Regeneration Potion
CONDITION_REGENERATION_POTION_0_DESCRIPTION	Regenerating 3 health.
CONDITION_REGENERATION_POTION_1_DESCRIPTION	Regenerating 8 health.
CONDITION_SPECTRAL_POWDER_NAME	Spectral Powder
CONDITION_SPECTRAL_POWDER_0_DESCRIPTION	Vanished. Cancels on attack.
CONDITION_WISP_CURSE_NAME	Wisp Curse
CONDITION_WISP_CURSE_1_DESCRIPTION	Decreases all power stats by 2.
CONDITION_WISP_CURSE_2_DESCRIPTION	Decreases all power stats by 5.
CONDITION_WISP_CURSE_3_DESCRIPTION	Decreases all power stats by 10.
CONDITION_WISP_CURSE_4_DESCRIPTION	Siphoned for 5 health.
CONDITION_EXECUTE_NAME	Execute
CONDITION_EXECUTE_1_DESCRIPTION	
CONDITION_BOUNCE_NAME	Bounce
CONDITION_BOUNCE_1_DESCRIPTION	Evasion increased by 100%.
CONDITION_DEVIOUS_SIGNET_NAME	Devious Signet
CONDITION_DEVIOUS_SIGNET_1_DESCRIPTION	Evasion and critical strike chances increased by 5%. Max stamina increased by 5.
CONDITION_DEVIOUS_SIGNET_2_DESCRIPTION	Evasion and critical strike chances increased by 5%. Max stamina increased by 10.
CONDITION_DEVIOUS_SIGNET_3_DESCRIPTION	Evasion and critical strike chances increased by 10%. Max stamina increased by 10.
CONDITION_DEVIOUS_SIGNET_4_DESCRIPTION	Evasion and critical strike chances increased by 10%. Max stamina increased by 15.
CONDITION_DEVIOUS_SIGNET_5_DESCRIPTION	Evasion and critical strike chances increased by 15%. Max stamina increased by 15.
CONDITION_DEVIOUS_SIGNET_6_DESCRIPTION	Evasion and critical strike chances increased by 15%. Max stamina increased by 20.
CONDITION_KILLER_JAB_NAME	Killer Jab
CONDITION_KILLER_JAB_1_DESCRIPTION	Defense decreased by 10. Movement speed decreased by 20%.
CONDITION_MIST_VEIL_NAME	Mist Veil
CONDITION_MIST_VEIL_1_DESCRIPTION	Grants invisibility and heals 5 health every 1.2 seconds. Attacking will remove the effect.
CONDITION_MIST_VEIL_2_DESCRIPTION	Grants invisibility and heals 5 health every 1.2 seconds. Attacking will remove the effect.
CONDITION_MIST_VEIL_3_DESCRIPTION	Grants invisibility and heals 5 health every 1.2 seconds. Attacking will remove the effect.
CONDITION_MIST_VEIL_4_DESCRIPTION	Grants invisibility and heals 5 health every 1.2 seconds. Attacking will remove the effect.
CONDITION_PAY_DAY_NAME	Pay Day
CONDITION_PAY_DAY_1_DESCRIPTION	Stunned and mugged by a Bandit.
CONDITION_PAY_DAY_2_DESCRIPTION	Stunned and mugged by a Bandit.
CONDITION_PAY_DAY_3_DESCRIPTION	Stunned and mugged by a Bandit.
CONDITION_PAY_DAY_4_DESCRIPTION	Stunned and mugged by a Bandit.
CONDITION_VENOM_SHOT_NAME	Venom Shot
CONDITION_VENOM_SHOT_1_DESCRIPTION	Poisoned. Defense decreased by 3.
CONDITION_VENOM_SHOT_2_DESCRIPTION	Poisoned. Defense decreased by 6.
CONDITION_VENOM_SHOT_3_DESCRIPTION	Poisoned. Defense decreased by 9.
CONDITION_VENOM_SHOT_4_DESCRIPTION	Poisoned. Defense decreased by 12.
CONDITION_VENOM_SHOT_5_DESCRIPTION	Poisoned. Defense decreased by 15.
CONDITION_VENOM_SHOT_6_DESCRIPTION	Poisoned. Defense decreased by 18.
CONDITION_BLOOD_GUSH_NAME	Blood Gush
CONDITION_BLOOD_GUSH_1_DESCRIPTION	Bleeding.
CONDITION_BLOOD_GUSH_2_DESCRIPTION	Bleeding.
CONDITION_BLOOD_GUSH_3_DESCRIPTION	Bleeding.
CONDITION_BLOOD_GUSH_4_DESCRIPTION	Bleeding.
CONDITION_LETHAL_STRIKE_NAME	Lethal Strike
CONDITION_LETHAL_STRIKE_1_DESCRIPTION	Evasion increased by 100%.
CONDITION_RAGE_NAME	Rage
CONDITION_RAGE_1_DESCRIPTION	All power Stats increased by <color=yellow>5.</color>
CONDITION_RAGE_2_DESCRIPTION	All power Stats increased by <color=yellow>8.</color>
CONDITION_RAGE_3_DESCRIPTION	All power Stats increased by <color=yellow>15.</color>
CONDITION_RAGE_4_DESCRIPTION	All power Stats increased by <color=yellow>20.</color>
CONDITION_RAGE_5_DESCRIPTION	All power Stats increased by <color=yellow>25.</color>
CONDITION_RAGE_6_DESCRIPTION	All power Stats increased by <color=yellow>32.</color>
CONDITION_SHIELD_BASH_NAME	Shield Bash
CONDITION_SHIELD_BASH_1_DESCRIPTION	Stunned.
CONDITION_SHIELD_BASH_2_DESCRIPTION	Stunned.
CONDITION_SHIELD_BASH_3_DESCRIPTION	Stunned.
CONDITION_SHIELD_BASH_4_DESCRIPTION	Stunned.
CONDITION_STOMP_NAME	Stomp
CONDITION_STOMP_1_DESCRIPTION	Slowed by 25%. Defense lowered by 15.
CONDITION_BLINK_NAME	Blink
CONDITION_BLINK_1_DESCRIPTION	Blinked.
CONDITION_CROSS_FLASH_NAME	Cross Flash
CONDITION_CROSS_FLASH_1_DESCRIPTION	Decreases Magic Defense by 5.
CONDITION_CROSS_FLASH_2_DESCRIPTION	Decreases Magic Defense by 10.
CONDITION_CROSS_FLASH_3_DESCRIPTION	Decreases Magic Defense by 15.
CONDITION_CROSS_FLASH_4_DESCRIPTION	Decreases Magic Defense by 20.
CONDITION_FLUXSPEAR_NAME	Fluxspear
CONDITION_FLUXSPEAR_1_DESCRIPTION	Stunned.
CONDITION_FLUXSPEAR_2_DESCRIPTION	Stunned.
CONDITION_FLUXSPEAR_3_DESCRIPTION	Stunned.
CONDITION_FLUXSPEAR_4_DESCRIPTION	Stunned.
CONDITION_IMBUE_NAME	Imbue
CONDITION_IMBUE_1_DESCRIPTION	Magic Power increased by 5, Magic Defense by 5, and Max Mana increased by 10.
CONDITION_IMBUE_2_DESCRIPTION	Magic Power increased by 10, Magic Defense by 5, and Max Mana increased by 10.
CONDITION_IMBUE_3_DESCRIPTION	Magic Power increased by 15, Magic Defense by 10, and Max Mana increased by 20.
CONDITION_IMBUE_4_DESCRIPTION	Magic Power increased by 20, Magic Defense by 10, and Max Mana increased by 20.
CONDITION_IMBUE_5_DESCRIPTION	Magic Power increased by 25, Magic Defense by 15, and Max Mana increased by 25.
CONDITION_PRISM_NAME	Prism
CONDITION_PRISM_1_DESCRIPTION	Absorbs up to 10 damage.
CONDITION_PRISM_2_DESCRIPTION	Absorbs up to 20 damage.
CONDITION_PRISM_3_DESCRIPTION	Absorbs up to 30 damage.
CONDITION_PRISM_4_DESCRIPTION	Absorbs up to 40 damage.
CONDITION_PRISM_5_DESCRIPTION	Absorbs up to 50 damage.
CONDITION_RESTORA_NAME	Restora
CONDITION_RESTORA_1_DESCRIPTION	Healed by Restora.
CONDITION_ALACRITY_NAME	Alacrity
CONDITION_ALACRITY_1_DESCRIPTION	The next skill is instant with no cost to mana, health or stamina based skills.
CONDITION_INNER_FOCUS_NAME	Inner Focus
CONDITION_INNER_FOCUS_1_DESCRIPTION	The next physical or magic attack will be a 100% crit chance.
CONDITION_LEG_UP_NAME	Leg Up
CONDITION_LEG_UP_1_DESCRIPTION	Movement speed increased by <color=yellow>20%.</color> Evasion increased by <color=yellow>12%.</color>
CONDITION_LEG_UP_2_DESCRIPTION	Movement speed increased by <color=yellow>30%.</color> Evasion increased by <color=yellow>14%.</color>
CONDITION_LEG_UP_3_DESCRIPTION	Movement speed increased by <color=yellow>40%.</color> Evasion increased by <color=yellow>16%.</color>
CONDITION_RECALL_NAME	Recall
CONDITION_RECALL_0_DESCRIPTION	
CONDITION_RECOVERY_NAME	Recovery
CONDITION_RECOVERY_1_DESCRIPTION	Heals <color=yellow>3</color> health every 2 seconds.
CONDITION_RECOVERY_2_DESCRIPTION	Heals <color=yellow>6</color> health every 2 seconds.
CONDITION_RECOVERY_3_DESCRIPTION	Heals <color=yellow>9</color> health every 2 seconds.
CONDITION_RECOVERY_4_DESCRIPTION	Heals <color=yellow>12</color> health every 2 seconds.
CONDITION_RECOVERY_5_DESCRIPTION	Heals <color=yellow>24%</color> of max health every 2 seconds.
CONDITION_SIPHON_LEECH_NAME	Siphon Leech
CONDITION_SIPHON_LEECH_1_DESCRIPTION	Deals 3 siphoning damage every second.
CONDITION_SIPHON_LEECH_2_DESCRIPTION	Deals 4 siphoning damage every second.
CONDITION_SIPHON_LEECH_3_DESCRIPTION	Deals 5 siphoning damage every second.
CONDITION_STURDY_NAME	Sturdy
CONDITION_STURDY_1_DESCRIPTION	Immune to knockback. Auto parries incoming attacks.
CONDITION_STURDY_2_DESCRIPTION	Immune to knockback. Auto parries incoming attacks.
CONDITION_STURDY_3_DESCRIPTION	Immune to knockback. Auto parries incoming attacks.
STAT_MODIFIER_DIVINE_TAG	Divine
STAT_MODIFIER_EARTHEN_TAG	Earthen
STAT_MODIFIER_ELDRITCH_TAG	Eldritch
STAT_MODIFIER_ENERGETIC_TAG	Energetic
STAT_MODIFIER_GUARDIAN_TAG	Guardian
STAT_MODIFIER_KILLER_TAG	Killer
STAT_MODIFIER_LIVELY_TAG	Lively
STAT_MODIFIER_MAGICAL_TAG	Magical
STAT_MODIFIER_MANAFONT_TAG	Manafont
STAT_MODIFIER_MOLTEN_TAG	Molten
STAT_MODIFIER_PRECISE_TAG	Precise
STAT_MODIFIER_TIDAL_TAG	Tidal
RACE_IMP_NAME	Imp
RACE_IMP_DESCRIPTION	Forsaken demons who come from an aquatic realm tangled with hellish machinery. By their own will, the Imps were not able to think or act for themselves, following orders from the occult who often summoned them.
RACE_IMP_MISC	Horns
RACE_POON_NAME	Poon
RACE_POON_DESCRIPTION	An ancient but thriving race of dryads who are tactful and cunning. Poons have adapted beyond being prey from the Deep Forest, able to take on any foe that stands against them.
RACE_POON_MISC	Antlers
RACE_KUBOLD_NAME	Kubold
RACE_KUBOLD_DESCRIPTION	Reptillian hermits who are naturally adept in the use of magic. The Kubold's homeland resides within a distant arid desert, sealed by arcane energies.
RACE_KUBOLD_MISC	Horns
RACE_BYRDLE_NAME	Byrdle
RACE_BYRDLE_DESCRIPTION	Elegant and dexterious travellers, and likely to be materialistic. Once matured, Byrdles are sworn to leave their flock from their kingdom to find their eternal destiny.
RACE_BYRDLE_MISC	Beak
RACE_CHANG_NAME	Chang
RACE_CHANG_DESCRIPTION	Compact, yet sturdy. Always eager for adventure beyond their scope. Changs come from a mysteriously advanced civilization, but were often outcasts and seen as troublemakers.
RACE_CHANG_MISC	Whiskers
COMBAT_ELEMENT_AIR_NAME	Air
COMBAT_ELEMENT_EARTH_NAME	Earth
COMBAT_ELEMENT_FIRE_NAME	Fire
COMBAT_ELEMENT_HOLY_NAME	Holy
COMBAT_ELEMENT_SHADOW_NAME	Shadow
COMBAT_ELEMENT_WATER_NAME	Water
PLAYER_CLASS_EMPTY_NAME	Novice
PLAYER_CLASS_FIGHTER_NAME	Fighter
PLAYER_CLASS_MYSTIC_NAME	Mystic
PLAYER_CLASS_BANDIT_NAME	Bandit
SKILL_BELL_MASTERY_NAME	Bell Mastery
SKILL_BELL_MASTERY_DESCRIPTION	Learns the ability to further utilize powers of Magic Bells, allowing the caster to charge attack with them.
SKILL_BELL_MASTERY_RANK_1_DESCRIPTOR	Unlocks the Magic Bell weapon charge. Hold $CHARGEATKINPUT to charge attack.\n<color=yellow>Costs 20 mana to charge attack.</color>
SKILL_BELL_MASTERY_RANK_2_DESCRIPTOR	Unlocks the Magic Bell weapon charge. Hold $CHARGEATKINPUT to charge attack.\n<color=yellow>Costs 15 mana to charge attack.</color>
SKILL_BELL_MASTERY_RANK_3_DESCRIPTOR	Unlocks the Magic Bell weapon charge. Hold $CHARGEATKINPUT to charge attack.\n<color=yellow>Costs 10 mana to charge attack.</color>
SKILL_H_MELEE_MASTERY_NAME	H. Melee Mastery
SKILL_H_MELEE_MASTERY_DESCRIPTION	Learns the ability to be more adept with heavy melee weaponry.
SKILL_H_MELEE_MASTERY_RANK_1_DESCRIPTOR	Unlocks the heavy melee charge attack. Hold $CHARGEATKINPUT to charge attack. <color=yellow>Costs 10 stamina.</color>
SKILL_H_MELEE_MASTERY_RANK_2_DESCRIPTOR	Unlocks the heavy melee charge attack. Hold $CHARGEATKINPUT to charge attack. <color=yellow>Costs 10 stamina.</color> Additionally upgrades the heavy melee jump attack.
SKILL_KATAR_MASTERY_NAME	Katar Mastery
SKILL_KATAR_MASTERY_DESCRIPTION	Learns the ability to be more adept with Katars.
SKILL_KATAR_MASTERY_RANK_1_DESCRIPTOR	Unlocks the katar charge attack. Hold $CHARGEATKINPUT to charge attack. <color=yellow>Costs 5 stamina.</color>
SKILL_KATAR_MASTERY_RANK_2_DESCRIPTOR	Unlocks the katar charge attack. Hold $CHARGEATKINPUT to charge attack. <color=yellow>Costs 5 stamina.</color> Additionally upgrades the katar jump attack.
SKILL_MELEE_MASTERY_NAME	Melee Mastery
SKILL_MELEE_MASTERY_DESCRIPTION	Learns the ability to be more adept with melee weaponry.
SKILL_MELEE_MASTERY_RANK_1_DESCRIPTOR	Unlocks the melee weapon charge attack. Hold $CHARGEATKINPUT to charge attack. <color=yellow>Costs 5 stamina.</color>
SKILL_MELEE_MASTERY_RANK_2_DESCRIPTOR	Unlocks the melee charge attack. Hold $CHARGEATKINPUT to charge attack. <color=yellow>Costs 5 stamina.</color> Additionally upgrades the melee jump attack.
SKILL_POLEARM_MASTERY_NAME	Polearm Mastery
SKILL_POLEARM_MASTERY_DESCRIPTION	Learns the ability to be more adept with polearms.
SKILL_POLEARM_MASTERY_RANK_1_DESCRIPTOR	Unlocks the polearm charge attack. Hold $CHARGEATKINPUT to charge attack. <color=yellow>Costs 5 stamina.</color>
SKILL_POLEARM_MASTERY_RANK_2_DESCRIPTOR	Unlocks the polearm charge attack. Hold $CHARGEATKINPUT to charge attack. <color=yellow>Costs 5 stamina.</color> Additionally upgrades the polearm jump attack.
SKILL_RANGED_MASTERY_NAME	Ranged Mastery
SKILL_RANGED_MASTERY_DESCRIPTION	Learns the ability to be more adept with ranged weaponry.
SKILL_RANGED_MASTERY_RANK_1_DESCRIPTOR	Increased ranged weapon attack speed by 10%.
SKILL_RANGED_MASTERY_RANK_2_DESCRIPTOR	Increased ranged weapon attack speed by 15%.
SKILL_RANGED_MASTERY_RANK_3_DESCRIPTOR	Increased ranged weapon attack speed by 20%.\n\nUnlocks the ranged weapon charge attack. Hold $CHARGEATKINPUT to charge attack. <color=yellow>Costs 5 stamina.</color>
SKILL_SCEPTER_MASTERY_NAME	Scepter Mastery
SKILL_SCEPTER_MASTERY_DESCRIPTION	Learns the ability to charge scepters, unleashing stronger projectiles upon release.
SKILL_SCEPTER_MASTERY_RANK_1_DESCRIPTOR	Unlocks the scepter charge attack. Hold $CHARGEATKINPUT to charge attack. <color=yellow>Costs 12 mana.</color>
SKILL_SCEPTER_MASTERY_RANK_2_DESCRIPTOR	Unlocks the scepter charge attack. Hold $CHARGEATKINPUT to charge attack. <color=yellow>Costs 10 mana.</color>
SKILL_SCEPTER_MASTERY_RANK_3_DESCRIPTOR	Unlocks the scepter charge attack. Hold $CHARGEATKINPUT to charge attack. <color=yellow>Costs 8 mana.</color>
SKILL_CRYO_NEEDLE_NAME	Cryo Needle
SKILL_CRYO_NEEDLE_DESCRIPTION	Casts a quick set of spinning ice needles.
SKILL_CRYO_NEEDLE_RANK_1_DESCRIPTOR	Shoots <color=yellow>3</color> frost needles, dealing $SKP damage each, with a <color=yellow>10%</color> chance to apply cold condition.
SKILL_CRYO_NEEDLE_RANK_2_DESCRIPTOR	Shoots <color=yellow>4</color> frost needles, dealing $SKP damage each, with a <color=yellow>10%</color> chance to apply cold condition.
SKILL_CRYO_NEEDLE_RANK_3_DESCRIPTOR	Shoots <color=yellow>5</color> frost needles, dealing $SKP damage each, with a <color=yellow>10%</color> chance to apply cold condition.
SKILL_DIVINE_NAME	Divine
SKILL_DIVINE_DESCRIPTION	Places a holy well below the caster, damaging targets and healing allies over time.
SKILL_DIVINE_RANK_1_DESCRIPTOR	Spawns a holy well, healing allies and damaging enemies by $SKP every 0.4 seconds when nearby. Lasts for <color=yellow>3.25 seconds.</color>
SKILL_DIVINE_RANK_2_DESCRIPTOR	Spawns a holy well, healing allies and damaging enemies by $SKP every 0.4 seconds when nearby. Lasts for <color=yellow>4.25 seconds.</color>
SKILL_DIVINE_RANK_3_DESCRIPTOR	Spawns a holy well, healing allies and damaging enemies by $SKP every 0.4 seconds when nearby. Lasts for <color=yellow>5.25 seconds.</color>
SKILL_EXECUTE_NAME	Execute
SKILL_EXECUTE_DESCRIPTION	Deals damage to a target, with a chance to kill them instantly if they are low on health. <color=lime>Requires a physical combat weapon.</color>
SKILL_EXECUTE_RANK_1_DESCRIPTOR	Deals $SKP initial damage. Has a <color=yellow>10%</color> chance to instantly kill a target that has less than <color=yellow>30%</color> health.
SKILL_EXECUTE_RANK_2_DESCRIPTOR	Deals $SKP initial damage. Has a <color=yellow>15%</color> chance to instantly kill a target that has less than <color=yellow>30%</color> health.
SKILL_EXECUTE_RANK_3_DESCRIPTOR	Deals $SKP initial damage. Has a <color=yellow>20%</color> chance to instantly kill a target that has less than <color=yellow>30%</color> health.
SKILL_FIREBALL_NAME	Fireball
SKILL_FIREBALL_DESCRIPTION	Casts an additional fireball each rank.
SKILL_FIREBALL_RANK_1_DESCRIPTOR	<color=yellow>Casts one fireball.</color> Deals $SKP damage. <color=yellow>5%</color> chance to cause burn condition, dealing $MKP damage every 3 seconds.
SKILL_FIREBALL_RANK_2_DESCRIPTOR	<color=yellow>Casts two fireballs.</color> Deals $SKP damage. <color=yellow>10%</color> chance to cause burn condition, dealing $MKP damage every 3 seconds.
SKILL_FIREBALL_RANK_3_DESCRIPTOR	<color=yellow>Casts three fireballs. The final fireball circles around the caster.</color> Deals $SKP damage. <color=yellow>15%</color> chance to cause burn condition, dealing $MKP damage every 3 seconds.
SKILL_GEYSER_NAME	Geyser
SKILL_GEYSER_DESCRIPTION	Casts a magical droplet that explodes into a freezing pillar when placed.
SKILL_GEYSER_RANK_1_DESCRIPTOR	
SKILL_LIFE_TAP_NAME	Life Tap
SKILL_LIFE_TAP_DESCRIPTION	Fully replenishes the casters mana with the cost of their health. <color=cyan>Ineffective if the caster doesnt have enough health or full mana.</color>
SKILL_LIFE_TAP_RANK_1_DESCRIPTOR	Restores all mana. Costs <color=yellow>50%</color> of the caster's max health.
SKILL_LIFE_TAP_RANK_2_DESCRIPTOR	Restores all mana. Costs <color=yellow>45%</color> of the caster's max health.
SKILL_LIFE_TAP_RANK_3_DESCRIPTOR	Restores all mana. Costs <color=yellow>40%</color> of the caster's max health.
SKILL_SPIRE_NAME	Spire
SKILL_SPIRE_DESCRIPTION	Molds the surface into a row of sharp spires.
SKILL_SPIRE_RANK_1_DESCRIPTOR	Spawns <color=yellow>3 Spires.</color> Each spire deals $SKP damage, with a <color=yellow>12%</color> chance to apply bleeding.
SKILL_SPIRE_RANK_2_DESCRIPTOR	Spawns <color=yellow>6 Spires.</color> Each spire deals $SKP damage, with a <color=yellow>12%</color> chance to apply bleeding.
SKILL_SPIRE_RANK_3_DESCRIPTOR	Spawns <color=yellow>9 Spires.</color> Each spire deals $SKP damage, with a <color=yellow>12%</color> chance to apply bleeding.
SKILL_SPREAD_SHOT_NAME	Spread Shot
SKILL_SPREAD_SHOT_DESCRIPTION	Shoots a spread of projectiles. <color=lime>Requires a ranged weapon.</color>
SKILL_SPREAD_SHOT_RANK_1_DESCRIPTOR	Shoots <color=yellow>3</color> projectiles, dealing $SKP damage.
SKILL_SPREAD_SHOT_RANK_2_DESCRIPTOR	Shoots <color=yellow>5</color> projectiles, dealing $SKP damage.
SKILL_SPREAD_SHOT_RANK_3_DESCRIPTOR	Shoots <color=yellow>7</color> projectiles, dealing $SKP damage.
SKILL_FLAK_NAME	Flak
SKILL_FLAK_DESCRIPTION	Casts a flurry of stone shards.
SKILL_FLAK_RANK_1_DESCRIPTOR	
SKILL_TALUS_NAME	Talus
SKILL_TALUS_DESCRIPTION	Forms a large boulder that smashes into the ground.
SKILL_TALUS_RANK_1_DESCRIPTOR	
SKILL_AGILE_TECHNIQUE_NAME	Agile Technique
SKILL_AGILE_TECHNIQUE_DESCRIPTION	The Bandit becomes more acrobatic, unlocking different methods of movement.
SKILL_AGILE_TECHNIQUE_RANK_1_DESCRIPTOR	<color=yellow>Unlocks triple jumping.</color>
SKILL_AGILE_TECHNIQUE_RANK_2_DESCRIPTOR	<color=yellow>Unlocks triple jumping.</color>\n\n<color=yellow>Unlocks the bounce ability. </color>Hold the dash input to bounce. <color=yellow>Costs 10 stamina.</color>
SKILL_AGILE_TECHNIQUE_RANK_3_DESCRIPTOR	<color=yellow>Unlocks triple jumping.</color>\n\n<color=yellow>Unlocks the bounce ability. </color>Hold the dash input to bounce. <color=yellow>Costs 10 stamina.</color>\n\n<color=yellow>Unlocks the dash long jump.</color> Double tap the dash button to do a long jump. <color=yellow>Costs 3 stamina.</color>
SKILL_BOUNCE_NAME	Bounce
SKILL_BOUNCE_DESCRIPTION	Lunges downwards, then bounces high upwards when hitting the ground.
SKILL_BOUNCE_RANK_1_DESCRIPTOR	Hold the dash input to bounce. <color=yellow>Costs 10 stamina.</color>
SKILL_BOMB_TRAP_NAME	Bomb Trap
SKILL_BOMB_TRAP_DESCRIPTION	Places an explosive trap that triggers within proximity of nearby targets.
SKILL_BOMB_TRAP_RANK_1_DESCRIPTOR	Deals $SKP damage, with a <color=yellow>small radius.</color>
SKILL_BOMB_TRAP_RANK_2_DESCRIPTOR	Deals $SKP damage, with a <color=yellow>medium radius.</color>
SKILL_BOMB_TRAP_RANK_3_DESCRIPTOR	Deals $SKP damage, with a <color=yellow>large radius.</color>
SKILL_BOMB_TRAP_RANK_4_DESCRIPTOR	Deals $SKP damage, with a <color=yellow>huge radius.</color>
SKILL_DEVIOUS_SIGNET_NAME	Devious Signet
SKILL_DEVIOUS_SIGNET_DESCRIPTION	Applies a signet to the Bandit and nearby allies, increasing evasion, max stamina, and critical strike chances.
SKILL_DEVIOUS_SIGNET_RANK_1_DESCRIPTOR	
SKILL_DEVIOUS_SIGNET_RANK_2_DESCRIPTOR	
SKILL_DEVIOUS_SIGNET_RANK_3_DESCRIPTOR	
SKILL_DEVIOUS_SIGNET_RANK_4_DESCRIPTOR	
SKILL_DEVIOUS_SIGNET_RANK_5_DESCRIPTOR	
SKILL_DEVIOUS_SIGNET_RANK_6_DESCRIPTOR	
SKILL_KILLER_JAB_NAME	Killer Jab
SKILL_KILLER_JAB_DESCRIPTION	Strikes the target, dealing strong initial damage and a poison debuff. <color=lime>Requires a physical combat weapon.</color>
SKILL_KILLER_JAB_RANK_1_DESCRIPTOR	Deals $SKP initial damage. Applies a poison debuff to the target, decreasing defense by <color=yellow>10</color> and movement speed by <color=yellow>20%.</color> 
SKILL_KILLER_JAB_RANK_2_DESCRIPTOR	Deals $SKP initial damage. Applies a poison debuff to the target, decreasing defense by <color=yellow>10</color> and movement speed by <color=yellow>20%.</color> 
SKILL_KILLER_JAB_RANK_3_DESCRIPTOR	Deals $SKP initial damage. Applies a poison debuff to the target, decreasing defense by <color=yellow>10</color> and movement speed by <color=yellow>20%.</color> 
SKILL_KILLER_JAB_RANK_4_DESCRIPTOR	Deals $SKP initial damage. Applies a poison debuff to the target, decreasing defense by <color=yellow>10</color> and movement speed by <color=yellow>20%.</color> 
SKILL_KILLER_JAB_RANK_5_DESCRIPTOR	Deals $SKP initial damage. Applies a poison debuff to the target, decreasing defense by <color=yellow>10</color> and movement speed by <color=yellow>20%.</color> 
SKILL_MIST_VEIL_NAME	Mist Veil
SKILL_MIST_VEIL_DESCRIPTION	The bandit evokes a mist from their body, vanishing themselves and healing for a short time.
SKILL_MIST_VEIL_RANK_1_DESCRIPTOR	
SKILL_MIST_VEIL_RANK_2_DESCRIPTOR	
SKILL_MIST_VEIL_RANK_3_DESCRIPTOR	
SKILL_MIST_VEIL_RANK_4_DESCRIPTOR	
SKILL_PAY_DAY_NAME	Pay Day
SKILL_PAY_DAY_DESCRIPTION	The Bandit stuns the target, additionally causing them to drop currency.\n<color=lime>Requires a physical combat weapon.</color>
SKILL_PAY_DAY_RANK_1_DESCRIPTOR	Deals $SKP initial damage, dropping <color=yellow>1 currency drop</color> on hit.
SKILL_PAY_DAY_RANK_2_DESCRIPTOR	Deals $SKP initial damage, dropping up to <color=yellow>2 currency drops</color> on hit.
SKILL_PAY_DAY_RANK_3_DESCRIPTOR	Deals $SKP initial damage, dropping up to <color=yellow>3 currency drops</color> on hit.
SKILL_PAY_DAY_RANK_4_DESCRIPTOR	Deals $SKP initial damage, dropping up to <color=yellow>4 currency drops</color> on hit.
SKILL_VENOM_SHOT_NAME	Venom Shot
SKILL_VENOM_SHOT_DESCRIPTION	Shoots a venom coated projectile. Deals damage over time, and decreases the target's defense. <color=lime>Requires a ranged weapon.</color>
SKILL_VENOM_SHOT_RANK_1_DESCRIPTOR	Defense decrease by <color=yellow>3.</color> Deals $SKP initial damage, then $RAP damage every 3 sec.
SKILL_VENOM_SHOT_RANK_2_DESCRIPTOR	Defense decrease by <color=yellow>6.</color> Deals $SKP initial damage, then $RAP damage every 3 sec.
SKILL_VENOM_SHOT_RANK_3_DESCRIPTOR	Defense decrease by <color=yellow>9.</color> Deals $SKP initial damage, then $RAP damage every 3 sec.
SKILL_VENOM_SHOT_RANK_4_DESCRIPTOR	Defense decrease by <color=yellow>12.</color> Deals $SKP initial damage, then $RAP damage every 3 sec.
SKILL_VENOM_SHOT_RANK_5_DESCRIPTOR	Defense decrease by <color=yellow>15.</color> Deals $SKP initial damage, then $RAP damage every 3 sec.
SKILL_VENOM_SHOT_RANK_6_DESCRIPTOR	Defense decrease by <color=yellow>18.</color> Deals $SKP initial damage, then $RAP damage every 3 sec.
SKILL_VOLLEY_NAME	Volley
SKILL_VOLLEY_DESCRIPTION	<color=cyan>Charge and release skill.</color> Fires a projectile in the air, raining shrapnel within a radius below. <color=lime>Requires a ranged weapon.</color>
SKILL_VOLLEY_RANK_1_DESCRIPTOR	Deals up to $SKP persistant damage.
SKILL_VOLLEY_RANK_2_DESCRIPTOR	Deals up to $SKP persistant damage.
SKILL_VOLLEY_RANK_3_DESCRIPTOR	Deals up to $SKP persistant damage.
SKILL_BULWARK_NAME	Bulwark
SKILL_BULWARK_DESCRIPTION	Bolsters the defensive strength of the Fighter.
SKILL_BULWARK_RANK_1_DESCRIPTOR	Decreases Stamina cost from getting hit while blocking by <color=yellow>15%.</color>
SKILL_BULWARK_RANK_2_DESCRIPTOR	Decreases Stamina cost from getting hit while blocking by <color=yellow>25%.</color>
SKILL_BULWARK_RANK_3_DESCRIPTOR	Decreases Stamina cost from getting hit while blocking by <color=yellow>50%.</color>
SKILL_BULWARK_RANK_4_DESCRIPTOR	Decreases Stamina cost from getting hit while blocking by <color=yellow>60%.</color>\n\nParry window and stagger time on targets increased by <color=yellow>0.4 seconds.</color>
SKILL_REFLECT_NAME	Reflect
SKILL_REFLECT_DESCRIPTION	Allows the Fighter to reflect melee damage if successfully parried.
SKILL_REFLECT_RANK_1_DESCRIPTOR	Deals <color=yellow>40%</color> of the incoming melee damage back to the target.
SKILL_REFLECT_RANK_2_DESCRIPTOR	Deals <color=yellow>80%</color> of the incoming melee damage back to the target.
SKILL_REFLECT_RANK_3_DESCRIPTOR	Deals <color=yellow>120%</color> of the incoming melee damage back to the target.
SKILL_BLOOD_GUSH_NAME	Blood Gush
SKILL_BLOOD_GUSH_DESCRIPTION	Deals initial damage, then applies a bleeding damage over time condition on hit.
SKILL_BLOOD_GUSH_RANK_1_DESCRIPTOR	Deals $SKP damage, then $ATP damage every 1.8 sec.
SKILL_BLOOD_GUSH_RANK_2_DESCRIPTOR	Deals $SKP damage, then $ATP damage every 1.8 sec.
SKILL_BLOOD_GUSH_RANK_3_DESCRIPTOR	Deals $SKP damage, then $ATP damage every 1.8 sec.
SKILL_BLOOD_GUSH_RANK_4_DESCRIPTOR	Deals $SKP damage, then $ATP damage every 1.8 sec.
SKILL_CYCLONE_NAME	Cyclone
SKILL_CYCLONE_DESCRIPTION	The Fighter throws their weapon as a boomerang, causing persistent damage to targets.
SKILL_CYCLONE_RANK_1_DESCRIPTOR	Deals up to $SKP persistent damage.
SKILL_CYCLONE_RANK_2_DESCRIPTOR	Deals up to $SKP persistent damage.
SKILL_CYCLONE_RANK_3_DESCRIPTOR	Deals up to $SKP persistent damage.
SKILL_CYCLONE_RANK_4_DESCRIPTOR	Deals up to $SKP persistent damage.
SKILL_CYCLONE_RANK_5_DESCRIPTOR	Deals up to $SKP persistent damage.
SKILL_LETHAL_STRIKE_NAME	Lethal Strike
SKILL_LETHAL_STRIKE_DESCRIPTION	<color=cyan>Charge and release skill.</color> Sends the Fighter into a dash, landing a heavy force attack on hit.
SKILL_LETHAL_STRIKE_RANK_1_DESCRIPTOR	Deals $SKP initial damage. $CASTTIME
SKILL_LETHAL_STRIKE_RANK_2_DESCRIPTOR	Deals $SKP initial damage. $CASTTIME
SKILL_LETHAL_STRIKE_RANK_3_DESCRIPTOR	Deals $SKP initial damage. $CASTTIME\n
SKILL_RAGE_NAME	Rage
SKILL_RAGE_DESCRIPTION	Drives the Fighter and their nearby allies into a fit of rage, <color=lime>increasing all power stats temporarily.</color>
SKILL_RAGE_RANK_1_DESCRIPTOR	
SKILL_RAGE_RANK_2_DESCRIPTOR	
SKILL_RAGE_RANK_3_DESCRIPTOR	
SKILL_RAGE_RANK_4_DESCRIPTOR	
SKILL_RAGE_RANK_5_DESCRIPTOR	
SKILL_RAGE_RANK_6_DESCRIPTOR	
SKILL_SHIELD_BASH_NAME	Shield Bash
SKILL_SHIELD_BASH_DESCRIPTION	The Fighter bashes with their shield, providing a stun for a short period on hit. <color=lime>Requires a held shield.</color>
SKILL_SHIELD_BASH_RANK_1_DESCRIPTOR	Deals $SKP initial damage, then stuns target for <color=yellow>1 sec.</color>
SKILL_SHIELD_BASH_RANK_2_DESCRIPTOR	Deals $SKP initial damage, then stuns target for <color=yellow>1.5 sec.</color>
SKILL_SHIELD_BASH_RANK_3_DESCRIPTOR	Deals $SKP initial damage, then stuns target for <color=yellow>2 sec.</color>
SKILL_SHIELD_BASH_RANK_4_DESCRIPTOR	Deals $SKP initial damage, then stuns target for <color=yellow>2.5 sec.</color>
SKILL_STOMP_NAME	Stomp
SKILL_STOMP_DESCRIPTION	Stomps at the ground, damaging nearby enemies. <color=lime>Generates high threat.</color>
SKILL_STOMP_RANK_1_DESCRIPTOR	Deals $SKP damage, with a <color=yellow>tiny radius.</color> Additionally slows the targets movement by <color=yellow>25%,</color> and lowers the targets defense by <color=yellow>15.</color>
SKILL_STOMP_RANK_2_DESCRIPTOR	Deals $SKP damage, with a <color=yellow>small radius.</color>\nAdditionally slows the targets movement by <color=yellow>25%,</color> and lowers the targets defense by <color=yellow>15.</color>
SKILL_STOMP_RANK_3_DESCRIPTOR	Deals $SKP damage, with a <color=yellow>medium radius.</color>\nAdditionally slows the targets movement by <color=yellow>25%,</color> and lowers the targets defense by <color=yellow>15.</color>
SKILL_STOMP_RANK_4_DESCRIPTOR	Deals $SKP damage, with a <color=yellow>large radius.</color>\nAdditionally slows the targets movement by <color=yellow>25%,</color> and lowers the targets defense by <color=yellow>15.</color>
SKILL_BLINK_NAME	Blink
SKILL_BLINK_DESCRIPTION	Unlocks the ability to quickly teleport from one point to another.
SKILL_BLINK_RANK_1_DESCRIPTOR	<color=yellow>Short</color> teleport distance. Costs <color=yellow=>5</color> mana. Double press the dash input to blink.
SKILL_BLINK_RANK_2_DESCRIPTOR	<color=yellow>Medium</color> teleport distance. Costs <color=yellow=>5</color> mana. Double press the dash input to blink.
SKILL_BLINK_RANK_3_DESCRIPTOR	<color=yellow>Long</color> teleport distance. Costs <color=yellow>5</color> mana. Double press the dash input to blink.
SKILL_MANAFLOW_NAME	Manaflow
SKILL_MANAFLOW_DESCRIPTION	Communes with the ley energies that surround the caster, recieving faster mana regeneration.
SKILL_MANAFLOW_RANK_1_DESCRIPTOR	Increases Mana Regeneration speed by <color=yellow>12%.</color>
SKILL_MANAFLOW_RANK_2_DESCRIPTOR	Increases Mana Regeneration speed by <color=yellow>24%.</color>
SKILL_MANAFLOW_RANK_3_DESCRIPTOR	Increases Mana Regeneration speed by <color=yellow>48%.</color>
SKILL_MANAFLOW_RANK_4_DESCRIPTOR	Increases Mana Regeneration speed by <color=yellow>60%.</color>
SKILL_MANAFLOW_RANK_5_DESCRIPTOR	Increases Mana Regeneration speed by <color=yellow>72%.</color>
SKILL_CROSS_NAME	Cross
SKILL_CROSS_DESCRIPTION	<color=cyan>Charge and release skill.</color> Manifests a source of explosive arcane magic.
SKILL_CROSS_RANK_1_DESCRIPTOR	Deals $SKP initial damage with a <color=yellow>small</color> blast radius. Additionally decreases affected target's Magic Defense by <color=yellow>5.</color>
SKILL_CROSS_RANK_2_DESCRIPTOR	Deals $SKP initial damage with a <color=yellow>medium</color> blast radius. Additionally decreases affected target's Magic Defense by <color=yellow>10.</color>
SKILL_CROSS_RANK_3_DESCRIPTOR	Deals $SKP initial damage with a <color=yellow>large</color> blast radius. Additionally decreases affected target's Magic Defense by <color=yellow>15.</color>
SKILL_CROSS_RANK_4_DESCRIPTOR	Deals $SKP initial damage with a <color=yellow>huge</color> blast radius. Additionally decreases affected target's Magic Defense by <color=yellow>20.</color>
SKILL_FLUXBOLT_NAME	Fluxbolt
SKILL_FLUXBOLT_DESCRIPTION	Casts a magic projectile that explodes on impact. Has potential to hit multiple times each rank.
SKILL_FLUXBOLT_RANK_1_DESCRIPTOR	$SKP Initial damage, hitting <color=yellow>once.</color>
SKILL_FLUXBOLT_RANK_2_DESCRIPTOR	$SKP Initial damage, hitting <color=yellow>twice.</color>
SKILL_FLUXBOLT_RANK_3_DESCRIPTOR	$SKP Initial damage, hitting <color=yellow>three times.</color>
SKILL_FLUXBOLT_RANK_4_DESCRIPTOR	$SKP Initial damage, <color=yellow>hitting four times.</color>
SKILL_FLUXBOLT_RANK_5_DESCRIPTOR	$SKP Initial damage, <color=yellow>hitting four times.</color>
SKILL_FLUXBOLT_RANK_6_DESCRIPTOR	$SKP Initial damage, <color=yellow>hitting four times.</color>
SKILL_FLUXBOLT_RANK_7_DESCRIPTOR	$SKP Initial damage, <color=yellow>hitting four times.</color>
SKILL_FLUXSPEAR_NAME	Fluxspear
SKILL_FLUXSPEAR_DESCRIPTION	Casts a piercing spear of arcane magic in front of the caster, dealing damage and stunning all adjacent targets.
SKILL_FLUXSPEAR_RANK_1_DESCRIPTOR	Deals $SKP initial damage. Stuns hit targets for <color=yellow>0.8 seconds.</color>
SKILL_FLUXSPEAR_RANK_2_DESCRIPTOR	Deals $SKP initial damage. Stuns hit targets for <color=yellow>1.2 seconds.</color>
SKILL_FLUXSPEAR_RANK_3_DESCRIPTOR	Deals $SKP initial damage. Stuns hit targets for <color=yellow>1.6 seconds.</color>
SKILL_FLUXSPEAR_RANK_4_DESCRIPTOR	Deals $SKP initial damage. Stuns hit targets for <color=yellow>2 seconds.</color>
SKILL_IMBUE_NAME	Imbue
SKILL_IMBUE_DESCRIPTION	Imbues a mystical spirit to the caster and nearby allies, <color=cyan>increasing their maximum mana and magic power.</color>
SKILL_IMBUE_RANK_1_DESCRIPTOR	
SKILL_IMBUE_RANK_2_DESCRIPTOR	
SKILL_IMBUE_RANK_3_DESCRIPTOR	
SKILL_IMBUE_RANK_4_DESCRIPTOR	
SKILL_IMBUE_RANK_5_DESCRIPTOR	
SKILL_NOVA_NAME	Nova
SKILL_NOVA_DESCRIPTION	Area of effect skill that emits a ring of magic energy around the caster, pushing back enemies.
SKILL_NOVA_RANK_1_DESCRIPTOR	Deals $SKP initial damage. 35% Knockback Force on hit.
SKILL_NOVA_RANK_2_DESCRIPTOR	Deals $SKP initial damage. 45% Knockback Force on hit.
SKILL_NOVA_RANK_3_DESCRIPTOR	Deals $SKP initial damage. 55% Knockback Force on hit.
SKILL_PRISM_NAME	Prism
SKILL_PRISM_DESCRIPTION	Forms a shield around the caster, absorbing any incoming damage.
SKILL_PRISM_RANK_1_DESCRIPTOR	
SKILL_PRISM_RANK_2_DESCRIPTOR	
SKILL_PRISM_RANK_3_DESCRIPTOR	
SKILL_PRISM_RANK_4_DESCRIPTOR	
SKILL_PRISM_RANK_5_DESCRIPTOR	
SKILL_RESTORA_NAME	Restora
SKILL_RESTORA_DESCRIPTION	Restores nearby allies health, including the Casters health.
SKILL_RESTORA_RANK_1_DESCRIPTOR	Heals the Caster and surrounding allies for $SKP hitpoints.
SKILL_RESTORA_RANK_2_DESCRIPTOR	Heals the Caster and surrounding allies for $SKP hitpoints.
SKILL_RESTORA_RANK_3_DESCRIPTOR	Heals the Caster and surrounding allies for $SKP hitpoints.
SKILL_RESTORA_RANK_4_DESCRIPTOR	Heals the Caster and surrounding allies for $SKP hitpoints.
SKILL_ALACRITY_NAME	Alacrity
SKILL_ALACRITY_DESCRIPTION	Applies a clearcast boon. The next cast will be instant with no mana, health or stamina cost.
SKILL_ALACRITY_RANK_1_DESCRIPTOR	$CASTTIME\n
SKILL_ALACRITY_RANK_2_DESCRIPTOR	$CASTTIME\n
SKILL_ALACRITY_RANK_3_DESCRIPTOR	$CASTTIME\n
SKILL_INNER_FOCUS_NAME	Inner Focus
SKILL_INNER_FOCUS_DESCRIPTION	Provides a buff that guarantees a 100% Critical Strike chance for the next attack.
SKILL_INNER_FOCUS_RANK_1_DESCRIPTOR	$CASTTIME
SKILL_INNER_FOCUS_RANK_2_DESCRIPTOR	$CASTTIME
SKILL_INNER_FOCUS_RANK_3_DESCRIPTOR	$CASTTIME
SKILL_LEG_UP_NAME	Leg Up
SKILL_LEG_UP_DESCRIPTION	Grants a movement speed increase buff, additionally increasing evasion.
SKILL_LEG_UP_RANK_1_DESCRIPTOR	
SKILL_LEG_UP_RANK_2_DESCRIPTOR	
SKILL_LEG_UP_RANK_3_DESCRIPTOR	
SKILL_RECALL_NAME	Recall
SKILL_RECALL_DESCRIPTION	Recalls the player back to Sanctum, spawning a portal to return where the caster recalled from. <color=lime>Can only cast outside of Sanctum.</color>
SKILL_RECALL_RANK_1_DESCRIPTOR	Takes you back to Sanctum.\nTo cast recall, press $RECALLINPUT.
SKILL_RECOVERY_NAME	Recovery
SKILL_RECOVERY_DESCRIPTION	Applies a healing condition that restores health over time.
SKILL_RECOVERY_RANK_1_DESCRIPTOR	
SKILL_RECOVERY_RANK_2_DESCRIPTOR	
SKILL_RECOVERY_RANK_3_DESCRIPTOR	
SKILL_RECOVERY_RANK_4_DESCRIPTOR	
SKILL_RECOVERY_RANK_5_DESCRIPTOR	
SKILL_ROCK_TOSS_NAME	Rock Toss
SKILL_ROCK_TOSS_DESCRIPTION	Tosses a rock, generating high threat on hit targets.
SKILL_ROCK_TOSS_RANK_1_DESCRIPTOR	Deals $SKP damage. $COOLDWN
SKILL_ROCK_TOSS_RANK_2_DESCRIPTOR	Deals $SKP damage. $COOLDWN
SKILL_ROCK_TOSS_RANK_3_DESCRIPTOR	Deals $SKP damage. $COOLDWN
SKILL_SIPHON_LEECH_NAME	Siphon Leech
SKILL_SIPHON_LEECH_DESCRIPTION	Shoots a siphoning projectile that spawns eldritch leeches on the hit target, healing the caster as they deal damage.
SKILL_SIPHON_LEECH_RANK_1_DESCRIPTOR	Deals $SKP initial damage, then $MKP siphoning damage every second.
SKILL_SIPHON_LEECH_RANK_2_DESCRIPTOR	Deals $SKP initial damage, then $MKP siphoning damage every second.
SKILL_SIPHON_LEECH_RANK_3_DESCRIPTOR	Deals $SKP initial damage, then $MKP siphoning damage every second.
SKILL_STURDY_NAME	Sturdy
SKILL_STURDY_DESCRIPTION	Provides a buff that grants immunity to knockback and auto parries incoming attacks.
SKILL_STURDY_RANK_1_DESCRIPTOR	
SKILL_STURDY_RANK_2_DESCRIPTOR	
SKILL_STURDY_RANK_3_DESCRIPTOR	
STAT_ATTRIBUTE_STRENGTH_NAME	Strength
STAT_ATTRIBUTE_STRENGTH_DESCRIPTOR	Increases Attack Power and Max Stamina.
STAT_ATTRIBUTE_MIND_NAME	Mind
STAT_ATTRIBUTE_MIND_DESCRIPTOR	Increases Magic Power and Max Mana.
STAT_ATTRIBUTE_DEXTERITY_NAME	Dexterity
STAT_ATTRIBUTE_DEXTERITY_DESCRIPTOR	Increases Dex Power, Attack Critical %, and Magic Critical %.
STAT_ATTRIBUTE_VITALITY_NAME	Vitality
STAT_ATTRIBUTE_VITALITY_DESCRIPTOR	Increases Max Health.
WEAPON_TYPE_UNARMED_NAME	Unarmed
WEAPON_TYPE_KATARS_NAME	Katars
WEAPON_TYPE_MELEE_NAME	Melee
WEAPON_TYPE_HEAVY_MELEE_NAME	Heavy Melee
WEAPON_TYPE_POLEARM_NAME	Polearm
WEAPON_TYPE_RANGE_WEAPON_NAME	Range Weapon
WEAPON_TYPE_MAGIC_SCEPTER_NAME	Magic Scepter
WEAPON_TYPE_MAGIC_BELL_NAME	Magic Bell
DIALOGDATA_ANGELA_NAME_TAG	Angela
DIALOGDATA_ANGELA_BRANCH_0_DIALOG_0_INPUT	Hm?
DIALOGDATA_ANGELA_BRANCH_0_DIALOG_0_INPUT_ALT_0	Hm?
DIALOGDATA_ANGELA_BRANCH_0_DIALOG_0_INPUT_ALT_1	Si?
DIALOGDATA_ANGELA_BRANCH_0_DIALOG_0_INPUT_ALT_2	Oh?
DIALOGDATA_ANGELA_BRANCH_0_DIALOG_0_SELECTION_0	Olvidalo...
DIALOGDATA_ANGELA_BRANCH_0_DIALOG_0_SELECTION_1	Me gustaria saber...
DIALOGDATA_ANGELA_BRANCH_0_DIALOG_0_SELECTION_2	Tienes alguna mision?
DIALOGDATA_ANGELA_BRANCH_1_DIALOG_0_INPUT	Bueno... veamos que puedes hacer, ¿te parece?
DIALOGDATA_ANGELA_BRANCH_1_DIALOG_0_INPUT_ALT_0	Bueno... veamos que puedemos hacer, ¿esta bien?
DIALOGDATA_ANGELA_BRANCH_1_DIALOG_0_INPUT_ALT_1	Hm, Bueno... Veamos...
DIALOGDATA_ANGELA_BRANCH_1_DIALOG_0_INPUT_ALT_2	A este mundo le vendraía bien un poco de pureza, ¿no?
DIALOGDATA_ANGELA_BRANCH_1_DIALOG_0_SELECTION_0	Te veo luego!
DIALOGDATA_ANGELA_BRANCH_1_DIALOG_0_SELECTION_1	Una cosa mas...
DIALOGDATA_ANGELA_BRANCH_2_DIALOG_0_INPUT	Mi conocimiento es tuyo, en que puedo ayudarte?
DIALOGDATA_ANGELA_BRANCH_2_DIALOG_0_SELECTION_0	Eh, bueno...
DIALOGDATA_ANGELA_BRANCH_2_DIALOG_0_SELECTION_1	Que son los Misticos?
DIALOGDATA_ANGELA_BRANCH_2_DIALOG_0_SELECTION_2	Donde estamos?
DIALOGDATA_ANGELA_BRANCH_2_DIALOG_0_SELECTION_3	Quien eres?
DIALOGDATA_ANGELA_BRANCH_2_DIALOG_0_SELECTION_4	Me han elegido?
DIALOGDATA_ANGELA_BRANCH_3_DIALOG_0_INPUT	Estas en el santuario, la ultima fortaleza de la paz de este mundo corrompido...
DIALOGDATA_ANGELA_BRANCH_3_DIALOG_1_INPUT	Ninguna creatura del mal puede entrar mientras este aqui. Asi lo quizo el destino, Estare Aqui solo para que el santuario este seguro.
DIALOGDATA_ANGELA_BRANCH_3_DIALOG_1_SELECTION_0	Ya veo. Entonces...
DIALOGDATA_ANGELA_BRANCH_4_DIALOG_0_INPUT	Eres muy curioso, pequeño...
DIALOGDATA_ANGELA_BRANCH_4_DIALOG_1_INPUT	Soy uno de los 3 guardianes que han vigilado esta tierra desde sus comienzos.
DIALOGDATA_ANGELA_BRANCH_4_DIALOG_2_INPUT	Antes podia verlo todo, pero mi magia se ha debilitado por... circuntancias desafortunadas.
DIALOGDATA_ANGELA_BRANCH_4_DIALOG_3_INPUT	Todo lo que puedo hacer ahora es mantener este mundo roto conectado, mantener el escudo del santuario Y alejarlo de la oscuridad.
DIALOGDATA_ANGELA_BRANCH_4_DIALOG_4_INPUT	Sin mi magia, tu alma estaria atrapada, Y perdida para siempre... Atascado en un lugar desconocido.
DIALOGDATA_ANGELA_BRANCH_4_DIALOG_4_SELECTION_0	Ya veo. Entonces...
DIALOGDATA_ANGELA_BRANCH_4_DIALOG_4_SELECTION_1	Es algo... Preocupante.
DIALOGDATA_ANGELA_BRANCH_5_DIALOG_0_INPUT	Estas en buenas manos, Pequeño...
DIALOGDATA_ANGELA_BRANCH_5_DIALOG_1_INPUT	Ten Fe, Hay muchas almas como la tuya que podrian heredar estas tierras puras.
DIALOGDATA_ANGELA_BRANCH_5_DIALOG_2_INPUT	Manten tu determinacion, Y manten tu cabeza en alto... Creo en ti.
DIALOGDATA_ANGELA_BRANCH_6_DIALOG_0_INPUT	Oh? T-tu estas interezado en mis estudios?
DIALOGDATA_ANGELA_BRANCH_6_DIALOG_1_INPUT	Bueno... 
DIALOGDATA_ANGELA_BRANCH_6_DIALOG_2_INPUT	Perdona, no es muy comun que me pregunten esto.
DIALOGDATA_ANGELA_BRANCH_6_DIALOG_3_INPUT	Eligir ser un mistico desbloquea todo el potencial de tu mente, dandote la habilidad de ejecutar poderos hechizos.
DIALOGDATA_ANGELA_BRANCH_6_DIALOG_4_INPUT	Puedes protegernos a nosostros con una barrera, Lanzar Estacas Explosivas, Y Atravesar objectivos cercanos...
DIALOGDATA_ANGELA_BRANCH_6_DIALOG_5_INPUT	Explicandolo Resumidamente, La magia arcana de los misticos usa tu propia energia...
DIALOGDATA_ANGELA_BRANCH_6_DIALOG_6_INPUT	Eso abarca muchas cosas, No te parece?
DIALOGDATA_ANGELA_BRANCH_7_DIALOG_0_INPUT	Ah, Si...
DIALOGDATA_ANGELA_BRANCH_7_DIALOG_1_INPUT	Tu no eres de este mundo, Pequeño. Una vez fuiste un ser vivo en un mundo muy distante al nuestro.
DIALOGDATA_ANGELA_BRANCH_7_DIALOG_2_INPUT	Cualquier cosa pudo haber ocurrido, de eso no tengo certeza...
DIALOGDATA_ANGELA_BRANCH_7_DIALOG_3_INPUT	He convocado tu alma, de entre muchas otras, para que vivas una vez mas, Y protejas este mundo de la oscuridad.
DIALOGDATA_ANGELA_BRANCH_7_DIALOG_4_INPUT	Me asegurare que tu alma se mantenga pura Y protegida de aquello que aceche fuera del santuario.
DIALOGDATA_ANGELA_BRANCH_7_DIALOG_4_SELECTION_0	Ya veo. Entonces...
DIALOGDATA_ANGELA_BRANCH_7_DIALOG_4_SELECTION_1	Porque me eligiste?
DIALOGDATA_ANGELA_BRANCH_8_DIALOG_0_INPUT	Esta es otra oportunidad para tu vida, no crees?
DIALOGDATA_ANGELA_BRANCH_8_DIALOG_1_INPUT	Entiendo que esto te parezca inquietante...
DIALOGDATA_ANGELA_BRANCH_8_DIALOG_2_INPUT	Sin embargo, El purgatorio despues de la muerte no es un tormento que merezcas sufrir. Tu alma descansa mejor en este lugar.
DIALOGDATA_ANGELA_BRANCH_8_DIALOG_3_INPUT	De eso estoy muy segura, Pequeño...
DIALOGDATA_ANGELA_BRANCH_9_DIALOG_0_INPUT	
DIALOGDATA_ANGELA_BRANCH_9_DIALOG_0_INPUT_ALT_0	Cuidate, Pequeño...
DIALOGDATA_ANGELA_BRANCH_9_DIALOG_0_INPUT_ALT_1	Siempre estare a tu lado.
DIALOGDATA_ANGELA_BRANCH_9_DIALOG_0_INPUT_ALT_2	Suerte, Pequeño.
DIALOGDATA_ANGELA_BRANCH_9_DIALOG_0_INPUT_ALT_3	Cuidate Mucho...
DIALOGDATA_ANGELA_INTRODUCTION_BRANCH_0_DIALOG_0_INPUT	
DIALOGDATA_ANGELA_INTRODUCTION_BRANCH_0_DIALOG_0_INPUT_ALT_0	Cielos!
DIALOGDATA_ANGELA_INTRODUCTION_BRANCH_0_DIALOG_0_INPUT_ALT_1	Ah!
DIALOGDATA_ANGELA_INTRODUCTION_BRANCH_0_DIALOG_0_INPUT_ALT_2	Oh por..!
DIALOGDATA_ANGELA_INTRODUCTION_BRANCH_0_DIALOG_1_INPUT	Que alivio ver que mi llamado a resultado... Por un momento pense que tu alma se habia perdido.
DIALOGDATA_ANGELA_INTRODUCTION_BRANCH_0_DIALOG_2_INPUT	Soy Angela Flux, La guardiana mistica del santuario.
DIALOGDATA_ANGELA_INTRODUCTION_BRANCH_0_DIALOG_3_INPUT	Se que tienes algunas preguntas por hacer...
DIALOGDATA_ANGELA_INTRODUCTION_BRANCH_0_DIALOG_4_INPUT	Pero primero, Conozcamos un poco este lugar, No?
DIALOGDATA_ANGELA_INTRODUCTION_BRANCH_0_DIALOG_4_SELECTION_0	Te veo luego!
DIALOGDATA_ANGELA_QUEST_ACCEPT_RESPONSE_0	Ah, Si... Esta si es una tarea en la que debemos centrarnos.
DIALOGDATA_ANGELA_QUEST_ACCEPT_RESPONSE_1	Porfavor ten cuidado... El mundo haya afuera es impredecible.
DIALOGDATA_ANGELA_QUEST_ACCEPT_RESPONSE_2	Tengo Fe en que tendras exito, aventurero...
DIALOGDATA_ANGELA_QUEST_ACCEPT_RESPONSE_3	Regresa sano y salvo...
DIALOGDATA_ANGELA_QUEST_COMPLETE_RESPONSE_0	Buen trabajo... Nos queda un largo camino por recorrer.
DIALOGDATA_ANGELA_QUEST_COMPLETE_RESPONSE_1	Oh, Maravilloso! Te dare una gran recompenza...
DIALOGDATA_ANGELA_QUEST_COMPLETE_RESPONSE_2	Haz demostrado ser un regalo para nosotros...
DIALOGDATA_ANGELA_QUEST_COMPLETE_RESPONSE_3	Una cosa menos de la que preocuparse....
DIALOGDATA_ANGELA_QUEST_COMPLETE_RESPONSE_4	Definitivamente, Tendras una recompenza por tus hazañas...
DIALOGDATA_ANGELA_QUEST_COMPLETE_RESPONSE_5	Bien hecho, porfavor descansa en cuanto puedas...
DIALOGDATA_ANGELA_QUEST_COMPLETE_RESPONSE_6	Me gusta esto, si...
DIALOGDATA_ENOK_NAME_TAG	Enok
DIALOGDATA_ENOK_BRANCH_0_DIALOG_0_INPUT	
DIALOGDATA_ENOK_BRANCH_0_DIALOG_0_INPUT_ALT_0	Escupe tus palabras, Rapido.
DIALOGDATA_ENOK_BRANCH_0_DIALOG_0_INPUT_ALT_1	Hay mucho trabajo por hacer.
DIALOGDATA_ENOK_BRANCH_0_DIALOG_0_INPUT_ALT_2	Habla.
DIALOGDATA_ENOK_BRANCH_0_DIALOG_0_SELECTION_0	Olvidalo.
DIALOGDATA_ENOK_BRANCH_0_DIALOG_0_SELECTION_1	Me gustaria Saber...
DIALOGDATA_ENOK_BRANCH_0_DIALOG_0_SELECTION_2	alguna mision?
DIALOGDATA_ENOK_BRANCH_1_DIALOG_0_INPUT	
DIALOGDATA_ENOK_BRANCH_1_DIALOG_0_INPUT_ALT_0	Si?
DIALOGDATA_ENOK_BRANCH_1_DIALOG_0_INPUT_ALT_1	Tengo una pregunta.
DIALOGDATA_ENOK_BRANCH_1_DIALOG_0_INPUT_ALT_2	No hay preguntas que deje sin responder.
DIALOGDATA_ENOK_BRANCH_1_DIALOG_0_INPUT_ALT_3	Te Escucho.
DIALOGDATA_ENOK_BRANCH_1_DIALOG_0_SELECTION_0	Eh, La verdad...
DIALOGDATA_ENOK_BRANCH_1_DIALOG_0_SELECTION_1	Quien eres?
DIALOGDATA_ENOK_BRANCH_1_DIALOG_0_SELECTION_2	Que son los luchadores?
DIALOGDATA_ENOK_BRANCH_1_DIALOG_0_SELECTION_3	Sobre Aturdir.
DIALOGDATA_ENOK_BRANCH_2_DIALOG_0_INPUT	Soy Enok, Guardian luchador. represento lo feroz que es la luz, asediando el infierno Y la oscuridad.
DIALOGDATA_ENOK_BRANCH_2_DIALOG_1_INPUT	Supongo que eres nuevo en este lugar. pero haz llegado tarde, en una epoca en la que todo esta corrompido.
DIALOGDATA_ENOK_BRANCH_2_DIALOG_2_INPUT	Mis poderes otorgan fuerza y vitalidad a aquellas almas que hayan probado ser dignas de poseerlo.
DIALOGDATA_ENOK_BRANCH_2_DIALOG_3_INPUT	Siento una chispa de determinacion en ti. Sucumbe al miedo, Y fallaras.
DIALOGDATA_ENOK_BRANCH_2_DIALOG_3_SELECTION_0	Adios.
DIALOGDATA_ENOK_BRANCH_2_DIALOG_3_SELECTION_1	Otra cosa...
DIALOGDATA_ENOK_BRANCH_3_DIALOG_0_INPUT	Un alma perdida puede ser un luchador feroz una vez ha probado ser lo suficientemente fuerte.
DIALOGDATA_ENOK_BRANCH_3_DIALOG_1_INPUT	Un luchador puede desgarrar a sus oponentes, y masacrarlos en una lluvia de sangre.
DIALOGDATA_ENOK_BRANCH_3_DIALOG_2_INPUT	Un luchador puede arrasar todo a su paso, con un golpe directo, un asedio letal a distancia.
DIALOGDATA_ENOK_BRANCH_3_DIALOG_3_INPUT	Hace falta un enfoque intensivo para dominar todo lo necesario para el arte del combate.
DIALOGDATA_ENOK_BRANCH_3_DIALOG_4_INPUT	Si crees que tienes lo necesario, ven conmigo, Y podre enseñarte.
DIALOGDATA_ENOK_BRANCH_3_DIALOG_4_SELECTION_0	Adios.
DIALOGDATA_ENOK_BRANCH_3_DIALOG_4_SELECTION_1	Ya veo, Entonces...
DIALOGDATA_ENOK_BRANCH_4_DIALOG_0_INPUT	
DIALOGDATA_ENOK_BRANCH_4_DIALOG_0_INPUT_ALT_0	Tenemos Asuntos que Atender.
DIALOGDATA_ENOK_BRANCH_4_DIALOG_0_INPUT_ALT_1	Veamos si esto es de tu talla.
DIALOGDATA_ENOK_BRANCH_4_DIALOG_0_INPUT_ALT_2	Hoy es un gran dia para un baño de sangre.
DIALOGDATA_ENOK_BRANCH_4_DIALOG_0_INPUT_ALT_3	Es hora de unir nuestras fuerzas.
DIALOGDATA_ENOK_BRANCH_4_DIALOG_0_SELECTION_0	Te veo luego!
DIALOGDATA_ENOK_BRANCH_4_DIALOG_0_SELECTION_1	Una cosa mas...
DIALOGDATA_ENOK_BRANCH_5_DIALOG_0_INPUT	Aturdir a tus oponentes es escencial en combate cuerpo a cuerpo.
DIALOGDATA_ENOK_BRANCH_5_DIALOG_1_INPUT	Para aturdirlos, bloquea rapidamente antes de que inicien su ataque.
DIALOGDATA_ENOK_BRANCH_5_DIALOG_2_INPUT	Si logras aturdirlos correctamente, no te costara energia el hacerlo.
DIALOGDATA_ENOK_BRANCH_5_DIALOG_3_INPUT	Excepto que, tus oponentes deben que tener una fuerza relativa a la tuya para que sea efectivo.
DIALOGDATA_ENOK_BRANCH_5_DIALOG_4_INPUT	Si luchas contra un enemigo y resulta ser mas fuerte que tu,
DIALOGDATA_ENOK_BRANCH_5_DIALOG_5_INPUT	flaquearas en hacerlo y perderas tu energia con facilidad.
DIALOGDATA_ENOK_BRANCH_5_DIALOG_6_INPUT	Observa tus enemigos con detenimiento. No hay nada imposible para ti si tienes una estrategia.
DIALOGDATA_ENOK_BRANCH_5_DIALOG_6_SELECTION_0	Te veo luego!
DIALOGDATA_ENOK_BRANCH_5_DIALOG_6_SELECTION_1	Una cosa mas...
DIALOGDATA_ENOK_INTRODUCTION_BRANCH_0_DIALOG_0_INPUT	Parece ser que tenemos carne fresca.
DIALOGDATA_ENOK_INTRODUCTION_BRANCH_0_DIALOG_1_INPUT	Si buscas volverte fuerte y seguir el camino del valor, habla conmigo.
DIALOGDATA_ENOK_INTRODUCTION_BRANCH_0_DIALOG_2_INPUT	Si tienes algo que decir, Dilo ahora.
DIALOGDATA_ENOK_INTRODUCTION_BRANCH_0_DIALOG_2_SELECTION_0	Olvidalo.
DIALOGDATA_ENOK_INTRODUCTION_BRANCH_0_DIALOG_2_SELECTION_1	Me gustaria Saber...
DIALOGDATA_ENOK_INTRODUCTION_BRANCH_0_DIALOG_2_SELECTION_2	Alguna Mision?
DIALOGDATA_ENOK_QUEST_ACCEPT_RESPONSE_0	Concedido.
DIALOGDATA_ENOK_QUEST_ACCEPT_RESPONSE_1	Que comienze la masacre.
DIALOGDATA_ENOK_QUEST_ACCEPT_RESPONSE_2	Es hora o nunca.
DIALOGDATA_ENOK_QUEST_COMPLETE_RESPONSE_0	Te estas volviendo muy fuerte en estas travesias, Uno menos.
DIALOGDATA_ENOK_QUEST_COMPLETE_RESPONSE_1	Bien hecho, Uno menos.
DIALOGDATA_ENOK_QUEST_COMPLETE_RESPONSE_2	La cazeria esta completa.
DIALOGDATA_ENOK_QUEST_COMPLETE_RESPONSE_3	Bien jugado.
DIALOGDATA_SANCTUMCIVILIAN_00_NAME_TAG	
DIALOGDATA_SANCTUMCIVILIAN_00_BRANCH_0_DIALOG_0_INPUT	
DIALOGDATA_SANCTUMCIVILIAN_00_BRANCH_0_DIALOG_0_INPUT_ALT_0	Hola.
DIALOGDATA_SANCTUMCIVILIAN_00_BRANCH_0_DIALOG_0_INPUT_ALT_1	Me parece que he visto tu rostro antes... O tal vez no.
DIALOGDATA_SANCTUMCIVILIAN_00_BRANCH_0_DIALOG_0_INPUT_ALT_2	Gracias al cielo que el santuario esta a salvo.
DIALOGDATA_SANCTUMCIVILIAN_00_INTRODUCTION_BRANCH_0_DIALOG_0_INPUT	
DIALOGDATA_SANCTUMCIVILIAN_00_INTRODUCTION_BRANCH_0_DIALOG_0_INPUT_ALT_0	Hola.
DIALOGDATA_SALLY_NAME_TAG	Sally
DIALOGDATA_SALLY_BRANCH_0_DIALOG_0_INPUT	Buenas! Es un placer verte!
DIALOGDATA_SALLY_BRANCH_0_DIALOG_0_INPUT_ALT_0	Buenas! Es un placer verte!
DIALOGDATA_SALLY_BRANCH_0_DIALOG_0_INPUT_ALT_1	Saludos! En que puedo ayudarte?
DIALOGDATA_SALLY_BRANCH_0_DIALOG_0_INPUT_ALT_2	Que puedo hacer por ti?
DIALOGDATA_SALLY_BRANCH_0_DIALOG_0_SELECTION_0	Olvidalo...
DIALOGDATA_SALLY_BRANCH_0_DIALOG_0_SELECTION_1	Que es esa creatura?
DIALOGDATA_SALLY_BRANCH_0_DIALOG_0_SELECTION_2	Alguna mision?
DIALOGDATA_SALLY_BRANCH_0_DIALOG_0_SELECTION_3	Quiero Commerciar!
DIALOGDATA_SALLY_BRANCH_1_DIALOG_0_INPUT	Oh si, Claro! Que vas a hacer en esta ocasion? Comprar O vender?
DIALOGDATA_SALLY_BRANCH_1_DIALOG_0_INPUT_ALT_0	Oh si, Claro! Que vas a hacer en esta ocasion? Comprar O vender?
DIALOGDATA_SALLY_BRANCH_1_DIALOG_0_INPUT_ALT_1	Tengo todo lo que necesitas!
DIALOGDATA_SALLY_BRANCH_1_DIALOG_0_INPUT_ALT_2	Nunca hay un mal dia para hacer negocios!
DIALOGDATA_SALLY_BRANCH_1_DIALOG_0_INPUT_ALT_3	Oh? Tienes algo brillante para mi?
DIALOGDATA_SALLY_BRANCH_1_DIALOG_0_SELECTION_0	Adios!
DIALOGDATA_SALLY_BRANCH_1_DIALOG_0_SELECTION_1	Alguna Mision?
DIALOGDATA_SALLY_BRANCH_2_DIALOG_0_INPUT	Si tienes algun intercambio por hacer, vuelve cuando quieras!
DIALOGDATA_SALLY_BRANCH_2_DIALOG_0_INPUT_ALT_0	Si tienes algun intercambio por hacer, vuelve cuando quieras!
DIALOGDATA_SALLY_BRANCH_2_DIALOG_0_INPUT_ALT_1	Siempre es un placer! 
DIALOGDATA_SALLY_BRANCH_2_DIALOG_0_INPUT_ALT_2	Ten cuidado, Cielo!
DIALOGDATA_SALLY_BRANCH_2_DIALOG_0_INPUT_ALT_3	Siempre estare aqui dia y noche!
DIALOGDATA_SALLY_BRANCH_2_DIALOG_0_INPUT_ALT_4	Cuidate Mucho, Me oyes?
DIALOGDATA_SALLY_BRANCH_3_DIALOG_0_INPUT	Ah, Ese es mi mimico mascota, Spike!. Descuida no muerde.
DIALOGDATA_SALLY_BRANCH_3_DIALOG_1_INPUT	Es muy amistoso, Aunque tambien es un dolor de cabeza. No se que haria sin el.
DIALOGDATA_SALLY_BRANCH_3_DIALOG_2_INPUT	Sabes?, Spike puede guardar tus objectos si no tienes espacio. No es genial?
DIALOGDATA_SALLY_BRANCH_4_DIALOG_0_INPUT	
DIALOGDATA_SALLY_BRANCH_4_DIALOG_0_INPUT_ALT_0	De hecho, Puede que si!
DIALOGDATA_SALLY_BRANCH_4_DIALOG_0_INPUT_ALT_1	Creo que tengo algo para ti!
DIALOGDATA_SALLY_BRANCH_4_DIALOG_0_INPUT_ALT_2	Hay que ocuparse de algunas cosas!
DIALOGDATA_SALLY_BRANCH_4_DIALOG_0_SELECTION_0	Adios.
DIALOGDATA_SALLY_BRANCH_4_DIALOG_0_SELECTION_1	A comerciar!
DIALOGDATA_SALLY_INTRODUCTION_BRANCH_0_DIALOG_0_INPUT	
DIALOGDATA_SALLY_INTRODUCTION_BRANCH_0_DIALOG_0_INPUT_ALT_0	Vaya, Vaya! Es agradable ver una nueva cara por estos lares!
DIALOGDATA_SALLY_INTRODUCTION_BRANCH_0_DIALOG_0_INPUT_ALT_1	Saludos! No creo haberte visto por aqui.
DIALOGDATA_SALLY_INTRODUCTION_BRANCH_0_DIALOG_0_INPUT_ALT_2	Hola, cariño, Pasa!
DIALOGDATA_SALLY_INTRODUCTION_BRANCH_0_DIALOG_0_INPUT_ALT_3	Es bueno ver a alguien nuevo por aqui!
DIALOGDATA_SALLY_INTRODUCTION_BRANCH_0_DIALOG_1_INPUT	Soy Sally! Bienvenido a mi tienda!
DIALOGDATA_SALLY_INTRODUCTION_BRANCH_0_DIALOG_2_INPUT	Tengo algunos bienes que te puedo vender, Pero tambien te puedo comprar! Si tienes algo valioso, traelo!
DIALOGDATA_SALLY_INTRODUCTION_BRANCH_0_DIALOG_3_INPUT	Muchos de mis amigos tambien estan dispersos por estas tierras! Saludalos de mi parte si los encuentras.
DIALOGDATA_SALLY_INTRODUCTION_BRANCH_0_DIALOG_4_INPUT	Haz me saber que puedo hacer por ti!
DIALOGDATA_SALLY_INTRODUCTION_BRANCH_0_DIALOG_4_SELECTION_0	A notado, Gracias!
DIALOGDATA_SALLY_INTRODUCTION_BRANCH_0_DIALOG_4_SELECTION_1	Alguna Mision?
DIALOGDATA_SALLY_INTRODUCTION_BRANCH_0_DIALOG_4_SELECTION_2	Veamos que tienes.
DIALOGDATA_SALLY_INTRODUCTION_BRANCH_1_DIALOG_0_INPUT	Claro, cariño!
DIALOGDATA_SALLY_SHOPKEEP_RESPONSE_0	Muchas gracias!
DIALOGDATA_SALLY_SHOPKEEP_RESPONSE_1	Siempre es un placer hacer negocios contigo!
DIALOGDATA_SALLY_SHOPKEEP_RESPONSE_2	Algo mas, cariño?
DIALOGDATA_SALLY_SHOPKEEP_RESPONSE_3	Esto es increible!
DIALOGDATA_SALLY_SHOPKEEP_RESPONSE_4	Brillante!
DIALOGDATA_SALLY_SHOPKEEP_RESPONSE_5	Un Gran intercambio!
DIALOGDATA_SALLY_SHOPKEEP_RESPONSE_6	Trato hecho!
DIALOGDATA_SALLY_SHOPKEEP_REJECTION_0	Lo siento cariño, esto aqui no vale mucho.
DIALOGDATA_SALLY_SHOPKEEP_REJECTION_1	No puedo quedarme con esto, Tal vez encuentres a alguien que si.
DIALOGDATA_SALLY_SHOPKEEP_REJECTION_2	Esto no tiene mucho valor que digamos.
DIALOGDATA_SALLY_SHOPKEEP_REJECTION_3	Hmm, Me temo que no puedo aceptar el trato.
DIALOGDATA_SALLY_QUEST_ACCEPT_RESPONSE_0	Veamos que me traes!
DIALOGDATA_SALLY_QUEST_ACCEPT_RESPONSE_1	Ve por ellos!
DIALOGDATA_SALLY_QUEST_ACCEPT_RESPONSE_2	Sabia decision!
DIALOGDATA_SALLY_QUEST_COMPLETE_RESPONSE_0	Que hay de nuevo? Fue divertido?
DIALOGDATA_SALLY_QUEST_COMPLETE_RESPONSE_1	Eres muy Sigiloso!
DIALOGDATA_SALLY_QUEST_COMPLETE_RESPONSE_2	Otro trabajo resulto, uno menos en la lista!
DIALOGDATA_SALLY_QUEST_COMPLETE_RESPONSE_3	Has regresado invicto Cariño, Me agrada!
DIALOGDATA_CRAIG_NAME_TAG	Craig
DIALOGDATA_CRAIG_BRANCH_0_DIALOG_0_INPUT	Hello my friend. Want to trade?
DIALOGDATA_CRAIG_BRANCH_0_DIALOG_0_SELECTION_0	See ya.
DIALOGDATA_CRAIG_BRANCH_0_DIALOG_0_SELECTION_1	Let's trade!
DIALOGDATA_CRAIG_BRANCH_1_DIALOG_0_INPUT	Okay, what's on the menu?
DIALOGDATA_CRAIG_BRANCH_1_DIALOG_0_SELECTION_0	See ya!
DIALOGDATA_CRAIG_INTRODUCTION_BRANCH_0_DIALOG_0_INPUT	Hello my friend...
DIALOGDATA_CRAIG_INTRODUCTION_BRANCH_0_DIALOG_1_INPUT	Interested in trading? (Hopefully you got something edible, I'm starving...)
DIALOGDATA_CRAIG_INTRODUCTION_BRANCH_0_DIALOG_1_SELECTION_0	Some other time.
DIALOGDATA_CRAIG_INTRODUCTION_BRANCH_0_DIALOG_1_SELECTION_1	Sure, let's trade.
DIALOGDATA_CRAIG_SHOPKEEP_RESPONSE_0	Hm, thanks much!
DIALOGDATA_CRAIG_SHOPKEEP_RESPONSE_1	Good trade.
DIALOGDATA_CRAIG_SHOPKEEP_RESPONSE_2	Mmm, mhm.
DIALOGDATA_CRAIG_SHOPKEEP_REJECTION_0	Can't take it.
DIALOGDATA_CRAIG_SHOPKEEP_REJECTION_1	Not interested, sorry.
DIALOGDATA_FRANKIE_NAME_TAG	Frankie
DIALOGDATA_FRANKIE_BRANCH_0_DIALOG_0_INPUT	Lookin' to buy somethin'?
DIALOGDATA_FRANKIE_BRANCH_0_DIALOG_0_SELECTION_0	Not now.
DIALOGDATA_FRANKIE_BRANCH_0_DIALOG_0_SELECTION_1	Isn't it dangerous?
DIALOGDATA_FRANKIE_BRANCH_0_DIALOG_0_SELECTION_2	Alright, I'll buy.
DIALOGDATA_FRANKIE_BRANCH_1_DIALOG_0_INPUT	
DIALOGDATA_FRANKIE_BRANCH_1_DIALOG_0_INPUT_ALT_0	I got some skill scrolls to sell!
DIALOGDATA_FRANKIE_BRANCH_1_DIALOG_0_INPUT_ALT_1	Interested in a Mekboar head?
DIALOGDATA_FRANKIE_BRANCH_1_DIALOG_0_INPUT_ALT_2	Got some Bunjars, Magicloves...
DIALOGDATA_FRANKIE_BRANCH_1_DIALOG_0_SELECTION_0	Seeya!
DIALOGDATA_FRANKIE_BRANCH_2_DIALOG_0_INPUT	Heh, funny you'd ask me that...
DIALOGDATA_FRANKIE_BRANCH_2_DIALOG_1_INPUT	No need to worry. Them boars aren't all that menacing to me.
DIALOGDATA_FRANKIE_BRANCH_2_DIALOG_2_INPUT	Though... the ones in the temple ahead seem a lil' scary. There's some treasure in there to loot, y'know...
DIALOGDATA_FRANKIE_BRANCH_2_DIALOG_3_INPUT	If I could find some way to get in without gettin' murdered, I'd be makin' some good business.
DIALOGDATA_FRANKIE_BRANCH_2_DIALOG_4_INPUT	Careful if ya ever consider going in there.
DIALOGDATA_FRANKIE_INTRODUCTION_BRANCH_0_DIALOG_0_INPUT	Heya, traveler! I'm Frankie.
DIALOGDATA_FRANKIE_INTRODUCTION_BRANCH_0_DIALOG_1_INPUT	I've got some interestin' goods for ya. Figure to check them out?
DIALOGDATA_FRANKIE_INTRODUCTION_BRANCH_0_DIALOG_1_SELECTION_0	Another time...
DIALOGDATA_FRANKIE_INTRODUCTION_BRANCH_0_DIALOG_1_SELECTION_1	Isn't it dangerous?
DIALOGDATA_FRANKIE_INTRODUCTION_BRANCH_0_DIALOG_1_SELECTION_2	Sure, I'll buy.
DIALOGDATA_FRANKIE_SHOPKEEP_RESPONSE_0	Thank ya kindly, traveller!
DIALOGDATA_FRANKIE_SHOPKEEP_RESPONSE_1	Pretty, pretty coin!
DIALOGDATA_FRANKIE_SHOPKEEP_RESPONSE_2	Not a bad choice, yeah?
DIALOGDATA_FRANKIE_SHOPKEEP_RESPONSE_3	Guess bein' out here ain't so bad.
DIALOGDATA_FRANKIE_SHOPKEEP_REJECTION_0	Can't do it, sorry!
DIALOGDATA_FRANKIE_SHOPKEEP_REJECTION_1	Not the business I'll take.
DIALOGDATA_FRANKIE_SHOPKEEP_REJECTION_2	Not lookin' for this.
DIALOGDATA_SKRIT_NAME_TAG	Skrit
DIALOGDATA_SKRIT_BRANCH_0_DIALOG_0_INPUT	
DIALOGDATA_SKRIT_BRANCH_0_DIALOG_0_INPUT_ALT_0	Skrit's got a few good shinies in store...
DIALOGDATA_SKRIT_BRANCH_0_DIALOG_0_INPUT_ALT_1	Skrit thinks ya feelin' lucky...
DIALOGDATA_SKRIT_BRANCH_0_DIALOG_0_INPUT_ALT_2	Let's tilt the scales...
DIALOGDATA_SKRIT_BRANCH_0_DIALOG_0_INPUT_ALT_3	Heh, ya ready to gamble?
DIALOGDATA_SKRIT_BRANCH_0_DIALOG_0_SELECTION_0	Maybe later.
DIALOGDATA_SKRIT_BRANCH_0_DIALOG_0_SELECTION_1	Gambling?
DIALOGDATA_SKRIT_BRANCH_0_DIALOG_0_SELECTION_2	Alright, let's do it.
DIALOGDATA_SKRIT_BRANCH_1_DIALOG_0_INPUT	
DIALOGDATA_SKRIT_BRANCH_1_DIALOG_0_INPUT_ALT_0	Heheh... Skrit's got the goods.
DIALOGDATA_SKRIT_BRANCH_1_DIALOG_0_INPUT_ALT_1	Skrit likes ya choice! Chk'Chk'Chk...
DIALOGDATA_SKRIT_BRANCH_1_DIALOG_0_INPUT_ALT_2	Let's see where the ball drops...
DIALOGDATA_SKRIT_BRANCH_1_DIALOG_0_INPUT_ALT_3	Many good shinies here...
DIALOGDATA_SKRIT_BRANCH_1_DIALOG_0_SELECTION_0	I'm done...
DIALOGDATA_SKRIT_BRANCH_2_DIALOG_0_INPUT	Ehh? Perhaps Skrit didn't realize to tell ya.
DIALOGDATA_SKRIT_BRANCH_2_DIALOG_1_INPUT	Give some coin to Skrit, and ya may get somethin' good in return...
DIALOGDATA_SKRIT_BRANCH_2_DIALOG_2_INPUT	It's none of ya business where Skrit gets the goods though! Keep it quiet!
DIALOGDATA_SKRIT_BRANCH_2_DIALOG_3_INPUT	Ya can re-roll the stock Skrit offers as well, no charge! Ya just can't see it till' ya buy it.
DIALOGDATA_SKRIT_BRANCH_2_DIALOG_4_INPUT	Skrit serves better stock when ya get stronger in ya journey. Keep that in mind.
DIALOGDATA_SKRIT_BRANCH_2_DIALOG_4_SELECTION_0	Alright, seeya.
DIALOGDATA_SKRIT_BRANCH_2_DIALOG_4_SELECTION_1	I'll play.
DIALOGDATA_SKRIT_INTRODUCTION_BRANCH_0_DIALOG_0_INPUT	
DIALOGDATA_SKRIT_INTRODUCTION_BRANCH_0_DIALOG_0_INPUT_ALT_0	Heh, what have we here?
DIALOGDATA_SKRIT_INTRODUCTION_BRANCH_0_DIALOG_0_INPUT_ALT_1	A potential customer, Skrit sees?
DIALOGDATA_SKRIT_INTRODUCTION_BRANCH_0_DIALOG_0_INPUT_ALT_2	Ahh... yes yes yes, Skrit welcomes ya...
DIALOGDATA_SKRIT_INTRODUCTION_BRANCH_0_DIALOG_1_INPUT	Thinkin' ya got some luck? Things not going the way ya want?
DIALOGDATA_SKRIT_INTRODUCTION_BRANCH_0_DIALOG_2_INPUT	Skrit welcomes some coin to give ya potential advantage to ya journey...
DIALOGDATA_SKRIT_INTRODUCTION_BRANCH_0_DIALOG_3_INPUT	Skrit knows his fair share of bad luck, but coin always talks. The shiny tilts the scale.
DIALOGDATA_SKRIT_INTRODUCTION_BRANCH_0_DIALOG_4_INPUT	If ya got some to throw in, speak to Skrit, heheh...
DIALOGDATA_SKRIT_INTRODUCTION_BRANCH_0_DIALOG_4_SELECTION_0	Nah, seeya.
DIALOGDATA_SKRIT_INTRODUCTION_BRANCH_0_DIALOG_4_SELECTION_1	I'll do it.
DIALOGDATA_SKRIT_SHOPKEEP_RESPONSE_0	Hm...
DIALOGDATA_SKRIT_SHOPKEEP_RESPONSE_1	Tried ya luck, eh?
DIALOGDATA_SKRIT_SHOPKEEP_RESPONSE_2	Ah, what's this? Eheheh...
DIALOGDATA_SKRIT_SHOPKEEP_RESPONSE_3	Skrit thinks this is a deal.
DIALOGDATA_SKRIT_SHOPKEEP_REJECTION_0	Skrit doesn't need ya stuff.
DIALOGDATA_SKRIT_SHOPKEEP_REJECTION_1	Ehhh, nah!
DIALOGDATA_SKRIT_SHOPKEEP_REJECTION_2	This isn't shiny coin!
DIALOGDATA_SKRIT_SHOPKEEP_REJECTION_3	You buy from Skrit, Skrit doesn't buy from ya!
DIALOGDATA_SPIKE_NAME_TAG	Spike
DIALOGDATA_SPIKE_BRANCH_0_DIALOG_0_INPUT	
DIALOGDATA_SPIKE_BRANCH_0_DIALOG_0_INPUT_ALT_0	Bark Bark! (Objectos, Objectos!!)
DIALOGDATA_SPIKE_BRANCH_0_DIALOG_0_INPUT_ALT_1	Roo, Roo, Roo! (Justo a tiempo! Donde esta la mercancia?)
DIALOGDATA_SPIKE_BRANCH_0_DIALOG_0_INPUT_ALT_2	Rooh, Bark!! (Tienes algo para mi?)
DIALOGDATA_SPIKE_BRANCH_0_DIALOG_0_SELECTION_0	Olvidalo...
DIALOGDATA_SPIKE_BRANCH_0_DIALOG_0_SELECTION_1	Abrir Almacenaje
DIALOGDATA_SPIKE_BRANCH_1_DIALOG_0_INPUT	Roh? (Que tienes para darme?)
DIALOGDATA_SPIKE_BRANCH_1_DIALOG_0_SELECTION_0	Te veo luego!
DIALOGDATA_SPIKE_BRANCH_2_DIALOG_0_INPUT	Grrr... (Es todo?)
DIALOGDATA_SPIKE_INTRODUCTION_BRANCH_0_DIALOG_0_INPUT	Bark Bark! (Objectos, Objectos!!)
DIALOGDATA_SPIKE_INTRODUCTION_BRANCH_0_DIALOG_0_SELECTION_0	Olvidalo...
DIALOGDATA_SPIKE_INTRODUCTION_BRANCH_1_DIALOG_0_INPUT	Grrr... (Es todo?)
DIALOGDATA_SPIKE_SHOPKEEP_RESPONSE_0	Thank ya kindly!
DIALOGDATA_SPIKE_SHOPKEEP_RESPONSE_1	Always a pleasure doin' business!
DIALOGDATA_SPIKE_SHOPKEEP_RESPONSE_2	Anything else, hun?
DIALOGDATA_SPIKE_SHOPKEEP_RESPONSE_3	Ain't this somethin'!
DIALOGDATA_SPIKE_SHOPKEEP_RESPONSE_4	Shiny!
DIALOGDATA_SPIKE_SHOPKEEP_RESPONSE_5	Quite the trade!
DIALOGDATA_SPIKE_SHOPKEEP_RESPONSE_6	It's a deal!
DIALOGDATA_SPIKE_SHOPKEEP_REJECTION_0	Sorry hun, this ain't worth much here.
DIALOGDATA_SPIKE_SHOPKEEP_REJECTION_1	Can't take it, mighta' need to find someone else who will.
DIALOGDATA_SPIKE_SHOPKEEP_REJECTION_2	Not much of a value on this one here.
DIALOGDATA_SPIKE_SHOPKEEP_REJECTION_3	Hmm, afraid I can't help ya on this trade.
DIALOGDATA_VANITYMIRROR_NAME_TAG	Mirror of Illusion
DIALOGDATA_VANITYMIRROR_BRANCH_0_DIALOG_0_INPUT	
DIALOGDATA_VANITYMIRROR_BRANCH_0_DIALOG_0_INPUT_ALT_0	Ah, yes. Have you sprung inspiration for a new look?
DIALOGDATA_VANITYMIRROR_BRANCH_0_DIALOG_0_INPUT_ALT_1	You seem inspired...
DIALOGDATA_VANITYMIRROR_BRANCH_0_DIALOG_0_INPUT_ALT_2	Are you ready to take on a new look?
DIALOGDATA_VANITYMIRROR_BRANCH_0_DIALOG_0_SELECTION_0	Goodbye.
DIALOGDATA_VANITYMIRROR_BRANCH_0_DIALOG_0_SELECTION_1	Illusion Stones?
DIALOGDATA_VANITYMIRROR_BRANCH_0_DIALOG_0_SELECTION_2	Equipment Vanity?
DIALOGDATA_VANITYMIRROR_BRANCH_0_DIALOG_0_SELECTION_3	Peer into the Mirror.
DIALOGDATA_VANITYMIRROR_BRANCH_1_DIALOG_0_INPUT	
DIALOGDATA_VANITYMIRROR_BRANCH_1_DIALOG_0_INPUT_ALT_0	Shall we begin?
DIALOGDATA_VANITYMIRROR_BRANCH_1_DIALOG_0_INPUT_ALT_1	What is your vision?
DIALOGDATA_VANITYMIRROR_BRANCH_1_DIALOG_0_INPUT_ALT_2	What is the look that you seek?
DIALOGDATA_VANITYMIRROR_BRANCH_1_DIALOG_0_INPUT_ALT_3	Let us commence.
DIALOGDATA_VANITYMIRROR_BRANCH_1_DIALOG_0_SELECTION_0	Goodbye.
DIALOGDATA_VANITYMIRROR_BRANCH_2_DIALOG_0_INPUT	Illusion Stones are the main source of my power, or rather, my service.
DIALOGDATA_VANITYMIRROR_BRANCH_2_DIALOG_1_INPUT	While not necessarily a currency, they are considered as a Trade Item.
DIALOGDATA_VANITYMIRROR_BRANCH_2_DIALOG_2_INPUT	Illusion Stones can be purchased for a high value, or be found from the outside world.
DIALOGDATA_VANITYMIRROR_BRANCH_2_DIALOG_3_INPUT	Each category you change your appearance in (Color, Head, Body), will cost one Illusion Stone each.
DIALOGDATA_VANITYMIRROR_BRANCH_2_DIALOG_3_SELECTION_0	I see, anyways...
DIALOGDATA_VANITYMIRROR_BRANCH_3_DIALOG_0_INPUT	My services are not needed to apply vanity to your gear.
DIALOGDATA_VANITYMIRROR_BRANCH_3_DIALOG_1_INPUT	However, you will need Illusion Stones to do this task.
DIALOGDATA_VANITYMIRROR_BRANCH_3_DIALOG_2_INPUT	Seek your inventory menu, and press the vanity button on the top right corner of the Tab Menu to access your vanity slots.
DIALOGDATA_VANITYMIRROR_BRANCH_3_DIALOG_3_INPUT	All but weapons and rings can be vanitized.
DIALOGDATA_VANITYMIRROR_BRANCH_3_DIALOG_4_INPUT	The equipment slot you wish to vanitize must have something equipped to override the look.
DIALOGDATA_VANITYMIRROR_BRANCH_3_DIALOG_5_INPUT	You will not be able to transmogrify equipment that is higher level than you, so keep that in mind.
DIALOGDATA_VANITYMIRROR_BRANCH_3_DIALOG_6_INPUT	I take it you have many ideas with this new found knowledge, yes?
DIALOGDATA_VANITYMIRROR_INTRODUCTION_BRANCH_0_DIALOG_0_INPUT	Greetings. I take it you may have some interest in me?
DIALOGDATA_VANITYMIRROR_INTRODUCTION_BRANCH_0_DIALOG_1_INPUT	I am the Mirror of Illusion, Angela's construct. My voice can only be heard between myself and the one who chooses to speak to me.
DIALOGDATA_VANITYMIRROR_INTRODUCTION_BRANCH_0_DIALOG_2_INPUT	Bring me Illusion Stones, and I can change your look permanently. Though, keep in mind that you cannot be in the form of another race.
DIALOGDATA_VANITYMIRROR_INTRODUCTION_BRANCH_0_DIALOG_2_SELECTION_0	Goodbye.
DIALOGDATA_VANITYMIRROR_INTRODUCTION_BRANCH_0_DIALOG_2_SELECTION_1	Illusion Stones?
DIALOGDATA_VANITYMIRROR_INTRODUCTION_BRANCH_0_DIALOG_2_SELECTION_2	Equipment Vanity?
DIALOGDATA_VANITYMIRROR_INTRODUCTION_BRANCH_0_DIALOG_2_SELECTION_3	Peer into the Mirror.
DIALOGDATA_VIVIAN_NAME_TAG	Vivian
DIALOGDATA_VIVIAN_BRANCH_0_DIALOG_0_INPUT	
DIALOGDATA_VIVIAN_BRANCH_0_DIALOG_0_INPUT_ALT_0	Hm, yeah?
DIALOGDATA_VIVIAN_BRANCH_0_DIALOG_0_INPUT_ALT_1	Yeah? What's up?
DIALOGDATA_VIVIAN_BRANCH_0_DIALOG_0_INPUT_ALT_2	Ehm, you need some enchanting done?
DIALOGDATA_VIVIAN_BRANCH_0_DIALOG_0_INPUT_ALT_3	Hey! Don't startle me like that. Geeze.
DIALOGDATA_VIVIAN_BRANCH_0_DIALOG_0_SELECTION_0	Nevermind.
DIALOGDATA_VIVIAN_BRANCH_0_DIALOG_0_SELECTION_1	About something...
DIALOGDATA_VIVIAN_BRANCH_0_DIALOG_0_SELECTION_2	Enchant my stuff!
DIALOGDATA_VIVIAN_BRANCH_1_DIALOG_0_INPUT	
DIALOGDATA_VIVIAN_BRANCH_1_DIALOG_0_INPUT_ALT_0	Alright, hope you got the funds.
DIALOGDATA_VIVIAN_BRANCH_1_DIALOG_0_INPUT_ALT_1	My services aren't cheap, so think hard.
DIALOGDATA_VIVIAN_BRANCH_1_DIALOG_0_INPUT_ALT_2	Hm? Oh right, we can do that.
DIALOGDATA_VIVIAN_BRANCH_1_DIALOG_0_INPUT_ALT_3	This better be something new for me to enchant...
DIALOGDATA_VIVIAN_BRANCH_1_DIALOG_0_INPUT_ALT_4	Oookay, let's do it.
DIALOGDATA_VIVIAN_BRANCH_1_DIALOG_0_SELECTION_0	Seeya!
DIALOGDATA_VIVIAN_BRANCH_2_DIALOG_0_INPUT	
DIALOGDATA_VIVIAN_BRANCH_2_DIALOG_0_INPUT_ALT_0	Uhm, yeah?
DIALOGDATA_VIVIAN_BRANCH_2_DIALOG_0_INPUT_ALT_1	No stupid questions, please...
DIALOGDATA_VIVIAN_BRANCH_2_DIALOG_0_INPUT_ALT_2	Is it about enchanting?
DIALOGDATA_VIVIAN_BRANCH_2_DIALOG_0_INPUT_ALT_3	Okay, I'm listening.
DIALOGDATA_VIVIAN_BRANCH_2_DIALOG_0_SELECTION_0	Nevermind.
DIALOGDATA_VIVIAN_BRANCH_2_DIALOG_0_SELECTION_1	You're cute!
DIALOGDATA_VIVIAN_BRANCH_2_DIALOG_0_SELECTION_2	Apprentice?
DIALOGDATA_VIVIAN_BRANCH_2_DIALOG_0_SELECTION_3	Enchanting?
DIALOGDATA_VIVIAN_BRANCH_2_DIALOG_0_SELECTION_4	Weapon Scaling?
DIALOGDATA_VIVIAN_BRANCH_3_DIALOG_0_INPUT	Okay, so this is how enchanting works.
DIALOGDATA_VIVIAN_BRANCH_3_DIALOG_1_INPUT	You give me a piece of equipment. Weapons or armor can do.
DIALOGDATA_VIVIAN_BRANCH_3_DIALOG_2_INPUT	Depending on the equipment, it'll cost crowns. Rare items will additionally need trade items to enchant.
DIALOGDATA_VIVIAN_BRANCH_3_DIALOG_3_INPUT	Make sure the equipment isn't formally exotic though, I can't enchant those.
DIALOGDATA_VIVIAN_BRANCH_3_DIALOG_4_INPUT	Enchanting is a delicate process, and it's nearly impossible to choose which one you want.
DIALOGDATA_VIVIAN_BRANCH_3_DIALOG_5_INPUT	Because of that, you will get a random enchantment each time.
DIALOGDATA_VIVIAN_BRANCH_3_DIALOG_6_INPUT	I hope you understood all that. I would rather not give you the run-down again.
DIALOGDATA_VIVIAN_BRANCH_3_DIALOG_6_SELECTION_0	Thanks, seeya!
DIALOGDATA_VIVIAN_BRANCH_3_DIALOG_6_SELECTION_1	I'll enchant something.
DIALOGDATA_VIVIAN_BRANCH_4_DIALOG_0_INPUT	
DIALOGDATA_VIVIAN_BRANCH_4_DIALOG_0_INPUT_ALT_0	Ugh, shut up...
DIALOGDATA_VIVIAN_BRANCH_4_DIALOG_0_INPUT_ALT_1	Yeah, that's not a question.
DIALOGDATA_VIVIAN_BRANCH_4_DIALOG_0_INPUT_ALT_2	You sure about that? You might not be saying that after I kick your face in.
DIALOGDATA_VIVIAN_BRANCH_4_DIALOG_0_INPUT_ALT_3	You know, some things are just better off being unsaid.
DIALOGDATA_VIVIAN_BRANCH_4_DIALOG_0_INPUT_ALT_4	Keep it to yourself, buddy.
DIALOGDATA_VIVIAN_BRANCH_5_DIALOG_0_INPUT	Yep, I'm Angela's apprentice. A Mystic, part of her studies.
DIALOGDATA_VIVIAN_BRANCH_5_DIALOG_1_INPUT	I've branched off to study more on enchanting rather than studying offensive magic.
DIALOGDATA_VIVIAN_BRANCH_5_DIALOG_2_INPUT	I think it's more chill. It makes good cash too, when things go well anyways.
DIALOGDATA_VIVIAN_BRANCH_5_DIALOG_3_INPUT	I respect Angela. If it weren't for her, I wouldn't be here. You should respect her too.
DIALOGDATA_VIVIAN_BRANCH_6_DIALOG_0_INPUT	Right. So, if you put an equippable weapon into the enchanting slot, you can change the damage scale of it.
DIALOGDATA_VIVIAN_BRANCH_6_DIALOG_1_INPUT	Depending on what you wanna do, you're gonna need some stones to do this sort of thing.
DIALOGDATA_VIVIAN_BRANCH_6_DIALOG_2_INPUT	For Strength, you'll need Might Stones.
DIALOGDATA_VIVIAN_BRANCH_6_DIALOG_3_INPUT	Dexterity will need Agility Stones.
DIALOGDATA_VIVIAN_BRANCH_6_DIALOG_4_INPUT	Lastly, Mind requires Flux Stones. Got it? Anyways...
DIALOGDATA_VIVIAN_BRANCH_6_DIALOG_5_INPUT	If the weapon is inherited to the scale you want, then it won't cost any stones. Cool, right?
DIALOGDATA_VIVIAN_BRANCH_6_DIALOG_6_INPUT	The stones can be found around the world, but they can also be sold from vendors too.
DIALOGDATA_VIVIAN_BRANCH_6_DIALOG_7_INPUT	The stones are pricy, so I won't cheap out on you and add more to the cost. So... you're welcome.
DIALOGDATA_VIVIAN_INTRODUCTION_BRANCH_0_DIALOG_0_INPUT	Hm? Oh hey. What's up?
DIALOGDATA_VIVIAN_INTRODUCTION_BRANCH_0_DIALOG_1_INPUT	I'm Vivian, Angela's apprentice.
DIALOGDATA_VIVIAN_INTRODUCTION_BRANCH_0_DIALOG_2_INPUT	My specality is enchanting weapons and armor.
DIALOGDATA_VIVIAN_INTRODUCTION_BRANCH_0_DIALOG_3_INPUT	If you got some cash, I can probably help you out. Just ask nicely.
DIALOGDATA_VIVIAN_INTRODUCTION_BRANCH_0_DIALOG_4_INPUT	Sooo... what's it gonna be? You interested in my services?
DIALOGDATA_VIVIAN_INTRODUCTION_BRANCH_0_DIALOG_4_SELECTION_0	Maybe later.
DIALOGDATA_VIVIAN_INTRODUCTION_BRANCH_0_DIALOG_4_SELECTION_1	You bet!
DIALOGDATA_VIVIAN_SHOPKEEP_RESPONSE_0	How many times are we gonna do this now?
DIALOGDATA_VIVIAN_SHOPKEEP_RESPONSE_1	You get what you get.
DIALOGDATA_VIVIAN_SHOPKEEP_RESPONSE_2	That doesn't look that bad, I guess.
DIALOGDATA_VIVIAN_SHOPKEEP_RESPONSE_3	Roll of the dice, as they say.
DIALOGDATA_VIVIAN_SHOPKEEP_RESPONSE_4	Hm, didn't think it'd come out this way.
DIALOGDATA_DUNGEONPORTAL_NAME_TAG	
DIALOGDATA_DUNGEONPORTAL_BRANCH_0_DIALOG_0_INPUT	What is your destiny?
DIALOGDATA_DUNGEONPORTAL_BRANCH_0_DIALOG_0_SELECTION_0	Cancel
DIALOGDATA_DUNGEONPORTAL_INTRODUCTION_BRANCH_0_DIALOG_0_INPUT	The portal eminates an evil power! It's unlike any other portal you've seen before.
DIALOGDATA_DUNGEONPORTAL_INTRODUCTION_BRANCH_0_DIALOG_1_INPUT	What is your destiny?
DIALOGDATA_DUNGEONPORTAL_INTRODUCTION_BRANCH_0_DIALOG_1_SELECTION_0	Cancel
ITEM_RARITY_COMMON	Common
ITEM_RARITY_RARE	Rare
ITEM_RARITY_EXOTIC	Exotic
ITEM_RARITY_LEGENDARY	Legendary
ITEM_RARITY_COSMETIC	Cosmetic
DAMAGE_TYPE_STRENGTH	Strength
DAMAGE_TYPE_DEXTERITY	Dexterity
DAMAGE_TYPE_MIND	Mind
DAMAGE_TYPE_PURE	Pure
DIALOGDATA_SANCTUMCIVILIAN_00_LOCAL_BRANCH_MAP_HUB_SANCTUM__CLIENTNPCS__NPC_SANCTUMCIVILIAN_RED__DIALOGTRIGGER_DIALOG_0_INPUT	
DIALOGDATA_SANCTUMCIVILIAN_00_LOCAL_BRANCH_MAP_HUB_SANCTUM__CLIENTNPCS__NPC_SANCTUMCIVILIAN_RED__DIALOGTRIGGER_DIALOG_0_INPUT_ALT_0	Strength defeats the weak! It's a known fact that Fighters have the upper hand.
DIALOGDATA_SANCTUMCIVILIAN_00_LOCAL_BRANCH_MAP_HUB_SANCTUM__CLIENTNPCS__NPC_SANCTUMCIVILIAN_RED__DIALOGTRIGGER_DIALOG_0_INPUT_ALT_1	Have you witnessed the strategy of Cyclone? It's my life long goal to learn it myself!
DIALOGDATA_SANCTUMCIVILIAN_00_LOCAL_BRANCH_MAP_HUB_SANCTUM__CLIENTNPCS__NPC_SANCTUMCIVILIAN_RED__DIALOGTRIGGER_DIALOG_0_INPUT_ALT_2	Enok is the guardian I worship. His determination and valor resonates with me.
DIALOGDATA_SANCTUMCIVILIAN_00_LOCAL_BRANCH_MAP_HUB_SANCTUM__CLIENTNPCS__NPC_SANCTUMCIVILIAN_BLU_06__DIALOGTRIGGER_DIALOG_0_INPUT	
DIALOGDATA_SANCTUMCIVILIAN_00_LOCAL_BRANCH_MAP_HUB_SANCTUM__CLIENTNPCS__NPC_SANCTUMCIVILIAN_BLU_06__DIALOGTRIGGER_DIALOG_0_INPUT_ALT_0	I hope to see the world safe again. It doesn't seem like that'll happen.
DIALOGDATA_SANCTUMCIVILIAN_00_LOCAL_BRANCH_MAP_HUB_SANCTUM__CLIENTNPCS__NPC_SANCTUMCIVILIAN_BLU_06__DIALOGTRIGGER_DIALOG_0_INPUT_ALT_1	Do you think the Sky Whale still watches us?
DIALOGDATA_SANCTUMCIVILIAN_00_LOCAL_BRANCH_MAP_HUB_SANCTUM__CLIENTNPCS__NPC_SANCTUMCIVILIAN_BLU_06__DIALOGTRIGGER_DIALOG_0_INPUT_ALT_2	I've witnessed the Shattering. I used to live in the Effold Terrace.
DIALOGDATA_SANCTUMCIVILIAN_00_LOCAL_BRANCH_MAP_HUB_SANCTUM__CLIENTNPCS__NPC_SANCTUMCIVILIAN_BLU_06__DIALOGTRIGGER_DIALOG_0_INPUT_ALT_3	Sigh...
DIALOGDATA_SANCTUMCIVILIAN_00_LOCAL_BRANCH_MAP_HUB_SANCTUM__CLIENTNPCS__NPC_SANCTUMCIVILIAN_BLU_01__DIALOGTRIGGER_DIALOG_0_INPUT	
DIALOGDATA_SANCTUMCIVILIAN_00_LOCAL_BRANCH_MAP_HUB_SANCTUM__CLIENTNPCS__NPC_SANCTUMCIVILIAN_BLU_01__DIALOGTRIGGER_DIALOG_0_INPUT_ALT_0	Did you know you can breathe underwater? It's a blessing from Angela.
DIALOGDATA_SANCTUMCIVILIAN_00_LOCAL_BRANCH_MAP_HUB_SANCTUM__CLIENTNPCS__NPC_SANCTUMCIVILIAN_BLU_01__DIALOGTRIGGER_DIALOG_0_INPUT_ALT_1	This water is so pure. We're so fortunate to have it.
DIALOGDATA_SANCTUMCIVILIAN_00_LOCAL_BRANCH_MAP_HUB_SANCTUM__CLIENTNPCS__NPC_SANCTUMCIVILIAN_BLU_01__DIALOGTRIGGER_DIALOG_0_INPUT_ALT_2	This is the Sanctum Lake. We tend to relax here when times are rough.
DIALOGDATA_SANCTUMCIVILIAN_00_LOCAL_BRANCH_MAP_HUB_SANCTUM__CLIENTNPCS__NPC_SANCTUMCIVILIAN_BLU_01__DIALOGTRIGGER_DIALOG_0_INPUT_ALT_3	Hm... I wonder what water spells are out there.
DIALOGDATA_SANCTUMCIVILIAN_00_LOCAL_BRANCH_MAP_HUB_SANCTUM__CLIENTNPCS__NPC_SANCTUMCIVILIAN_BLU_02__DIALOGTRIGGER_DIALOG_0_INPUT	
DIALOGDATA_SANCTUMCIVILIAN_00_LOCAL_BRANCH_MAP_HUB_SANCTUM__CLIENTNPCS__NPC_SANCTUMCIVILIAN_BLU_02__DIALOGTRIGGER_DIALOG_0_INPUT_ALT_0	Angela's writing is so divine!
DIALOGDATA_SANCTUMCIVILIAN_00_LOCAL_BRANCH_MAP_HUB_SANCTUM__CLIENTNPCS__NPC_SANCTUMCIVILIAN_BLU_02__DIALOGTRIGGER_DIALOG_0_INPUT_ALT_1	I've been practicing Fluxbolt. I can only get it to hit a couple times...
DIALOGDATA_SANCTUMCIVILIAN_00_LOCAL_BRANCH_MAP_HUB_SANCTUM__CLIENTNPCS__NPC_SANCTUMCIVILIAN_BLU_02__DIALOGTRIGGER_DIALOG_0_INPUT_ALT_2	The sound of arcane magic brings me joy.
DIALOGDATA_SANCTUMCIVILIAN_00_LOCAL_BRANCH_MAP_HUB_SANCTUM__CLIENTNPCS__NPC_SANCTUMCIVILIAN_BLU_02__DIALOGTRIGGER_DIALOG_0_INPUT_ALT_3	Imbue is a very powerful spell. It can make your melee weapons magical!
DIALOGDATA_SANCTUMCIVILIAN_00_LOCAL_BRANCH_MAP_HUB_SANCTUM__CLIENTNPCS__NPC_SANCTUMCIVILIAN_BLU_03__DIALOGTRIGGER_DIALOG_0_INPUT	
DIALOGDATA_SANCTUMCIVILIAN_00_LOCAL_BRANCH_MAP_HUB_SANCTUM__CLIENTNPCS__NPC_SANCTUMCIVILIAN_BLU_03__DIALOGTRIGGER_DIALOG_0_INPUT_ALT_0	I'm sorry, I'm quite busy.
DIALOGDATA_SANCTUMCIVILIAN_00_LOCAL_BRANCH_MAP_HUB_SANCTUM__CLIENTNPCS__NPC_SANCTUMCIVILIAN_BLU_03__DIALOGTRIGGER_DIALOG_0_INPUT_ALT_1	No time to chat, I'm trying to study something.
DIALOGDATA_SANCTUMCIVILIAN_00_LOCAL_BRANCH_MAP_HUB_SANCTUM__CLIENTNPCS__NPC_SANCTUMCIVILIAN_BLU_03__DIALOGTRIGGER_DIALOG_0_INPUT_ALT_2	...
DIALOGDATA_SANCTUMCIVILIAN_00_LOCAL_BRANCH_MAP_HUB_SANCTUM__CLIENTNPCS__NPC_SANCTUMCIVILIAN_BLU_03__DIALOGTRIGGER_DIALOG_0_INPUT_ALT_3	Hm... oh? Sorry, I can't talk right now.
DIALOGDATA_SANCTUMCIVILIAN_00_LOCAL_BRANCH_MAP_HUB_SANCTUM__CLIENTNPCS__NPC_SANCTUMCIVILIAN_BLU_04__DIALOGTRIGGER_DIALOG_0_INPUT	
DIALOGDATA_SANCTUMCIVILIAN_00_LOCAL_BRANCH_MAP_HUB_SANCTUM__CLIENTNPCS__NPC_SANCTUMCIVILIAN_BLU_04__DIALOGTRIGGER_DIALOG_0_INPUT_ALT_0	Greetings. I see you have come to this world in peace.
DIALOGDATA_SANCTUMCIVILIAN_00_LOCAL_BRANCH_MAP_HUB_SANCTUM__CLIENTNPCS__NPC_SANCTUMCIVILIAN_BLU_04__DIALOGTRIGGER_DIALOG_0_INPUT_ALT_1	My colleague thinks you look cute.
DIALOGDATA_SANCTUMCIVILIAN_00_LOCAL_BRANCH_MAP_HUB_SANCTUM__CLIENTNPCS__NPC_SANCTUMCIVILIAN_BLU_04__DIALOGTRIGGER_DIALOG_0_INPUT_ALT_2	There's such little time to learn.
DIALOGDATA_SANCTUMCIVILIAN_00_LOCAL_BRANCH_MAP_HUB_SANCTUM__CLIENTNPCS__NPC_SANCTUMCIVILIAN_BLU_05__DIALOGTRIGGER_DIALOG_0_INPUT	
DIALOGDATA_SANCTUMCIVILIAN_00_LOCAL_BRANCH_MAP_HUB_SANCTUM__CLIENTNPCS__NPC_SANCTUMCIVILIAN_BLU_05__DIALOGTRIGGER_DIALOG_0_INPUT_ALT_0	Hail, lost soul. Does this place entice you?
DIALOGDATA_SANCTUMCIVILIAN_00_LOCAL_BRANCH_MAP_HUB_SANCTUM__CLIENTNPCS__NPC_SANCTUMCIVILIAN_BLU_05__DIALOGTRIGGER_DIALOG_0_INPUT_ALT_1	This Tower brings me solitude.
DIALOGDATA_SANCTUMCIVILIAN_00_LOCAL_BRANCH_MAP_HUB_SANCTUM__CLIENTNPCS__NPC_SANCTUMCIVILIAN_BLU_05__DIALOGTRIGGER_DIALOG_0_INPUT_ALT_2	My colleague seems to like you.
DIALOGDATA_SANCTUMCIVILIAN_00_LOCAL_BRANCH_MAP_HUB_SANCTUM__CLIENTNPCS__NPC_SANCTUMCIVILIAN_GRN__DIALOGTRIGGER_DIALOG_0_INPUT	
DIALOGDATA_SANCTUMCIVILIAN_00_LOCAL_BRANCH_MAP_HUB_SANCTUM__CLIENTNPCS__NPC_SANCTUMCIVILIAN_GRN__DIALOGTRIGGER_DIALOG_0_INPUT_ALT_0	These two don't know what it takes to be truly agile. If only they knew...
DIALOGDATA_SANCTUMCIVILIAN_00_LOCAL_BRANCH_MAP_HUB_SANCTUM__CLIENTNPCS__NPC_SANCTUMCIVILIAN_GRN__DIALOGTRIGGER_DIALOG_0_INPUT_ALT_1	Nothing beats the power of wit and speed. Fighters and Mystics don't stand a chance against Bandits.
DIALOGDATA_SANCTUMCIVILIAN_00_LOCAL_BRANCH_MAP_HUB_SANCTUM__CLIENTNPCS__NPC_SANCTUMCIVILIAN_GRN__DIALOGTRIGGER_DIALOG_0_INPUT_ALT_2	Have you spoken to Sally? She's remarkable.
DIALOGDATA_SANCTUMCIVILIAN_00_LOCAL_BRANCH_MAP_HUB_SANCTUM__CLIENTNPCS__NPC_SANCTUMCIVILIAN_BLU__DIALOGTRIGGER_DIALOG_0_INPUT	
DIALOGDATA_SANCTUMCIVILIAN_00_LOCAL_BRANCH_MAP_HUB_SANCTUM__CLIENTNPCS__NPC_SANCTUMCIVILIAN_BLU__DIALOGTRIGGER_DIALOG_0_INPUT_ALT_0	It is quite clear that the way of the Mystic is far more superior than the others.
DIALOGDATA_SANCTUMCIVILIAN_00_LOCAL_BRANCH_MAP_HUB_SANCTUM__CLIENTNPCS__NPC_SANCTUMCIVILIAN_BLU__DIALOGTRIGGER_DIALOG_0_INPUT_ALT_1	Spellcasting is the better option, there are no exceptions!
DIALOGDATA_SANCTUMCIVILIAN_00_LOCAL_BRANCH_MAP_HUB_SANCTUM__CLIENTNPCS__NPC_SANCTUMCIVILIAN_BLU__DIALOGTRIGGER_DIALOG_0_INPUT_ALT_2	Angela knows best, and she's the one that knows more than the others.
DIALOGDATA_SANCTUMCIVILIAN_00_LOCAL_BRANCH_MAP_HUB_SANCTUM__CLIENTNPCS__NPC_SANCTUMCIVILIAN_BLU__DIALOGTRIGGER_DIALOG_0_INPUT_ALT_3	I have quite a lot of things to study soon...
DIALOGDATA_SANCTUMCIVILIAN_00_LOCAL_BRANCH_MAP_HUB_SANCTUM__CLIENTNPCS__NPC_SANCTUMCIVILIAN_RED_08__DIALOGTRIGGER_DIALOG_0_INPUT	
DIALOGDATA_SANCTUMCIVILIAN_00_LOCAL_BRANCH_MAP_HUB_SANCTUM__CLIENTNPCS__NPC_SANCTUMCIVILIAN_RED_08__DIALOGTRIGGER_DIALOG_0_INPUT_ALT_0	Heya, welcome to the Barracks!
DIALOGDATA_SANCTUMCIVILIAN_00_LOCAL_BRANCH_MAP_HUB_SANCTUM__CLIENTNPCS__NPC_SANCTUMCIVILIAN_RED_08__DIALOGTRIGGER_DIALOG_0_INPUT_ALT_1	You've met Enok, correct? He is the Fighter Guardian.
DIALOGDATA_SANCTUMCIVILIAN_00_LOCAL_BRANCH_MAP_HUB_SANCTUM__CLIENTNPCS__NPC_SANCTUMCIVILIAN_RED_08__DIALOGTRIGGER_DIALOG_0_INPUT_ALT_2	My strength communes with Enok's powers.
DIALOGDATA_SANCTUMCIVILIAN_00_LOCAL_BRANCH_MAP_HUB_SANCTUM__CLIENTNPCS__NPC_SANCTUMCIVILIAN_RED_02__DIALOGTRIGGER_DIALOG_0_INPUT	
DIALOGDATA_SANCTUMCIVILIAN_00_LOCAL_BRANCH_MAP_HUB_SANCTUM__CLIENTNPCS__NPC_SANCTUMCIVILIAN_RED_02__DIALOGTRIGGER_DIALOG_0_INPUT_ALT_0	Hi there!
DIALOGDATA_SANCTUMCIVILIAN_00_LOCAL_BRANCH_MAP_HUB_SANCTUM__CLIENTNPCS__NPC_SANCTUMCIVILIAN_RED_02__DIALOGTRIGGER_DIALOG_0_INPUT_ALT_1	I see you're not from this world. We're natives here. Lost souls are always welcome.
DIALOGDATA_SANCTUMCIVILIAN_00_LOCAL_BRANCH_MAP_HUB_SANCTUM__CLIENTNPCS__NPC_SANCTUMCIVILIAN_RED_02__DIALOGTRIGGER_DIALOG_0_INPUT_ALT_2	As long as you assist us in this dire time, you're free to rest here!
DIALOGDATA_SANCTUMCIVILIAN_00_LOCAL_BRANCH_MAP_HUB_SANCTUM__CLIENTNPCS__NPC_SANCTUMCIVILIAN_RED_07__DIALOGTRIGGER_DIALOG_0_INPUT	
DIALOGDATA_SANCTUMCIVILIAN_00_LOCAL_BRANCH_MAP_HUB_SANCTUM__CLIENTNPCS__NPC_SANCTUMCIVILIAN_RED_07__DIALOGTRIGGER_DIALOG_0_INPUT_ALT_0	Welcome to the Barracks, adventurer.
DIALOGDATA_SANCTUMCIVILIAN_00_LOCAL_BRANCH_MAP_HUB_SANCTUM__CLIENTNPCS__NPC_SANCTUMCIVILIAN_RED_07__DIALOGTRIGGER_DIALOG_0_INPUT_ALT_1	Master Enok knows of your presence. Don't disappoint him.
DIALOGDATA_SANCTUMCIVILIAN_00_LOCAL_BRANCH_MAP_HUB_SANCTUM__CLIENTNPCS__NPC_SANCTUMCIVILIAN_RED_07__DIALOGTRIGGER_DIALOG_0_INPUT_ALT_2	If only I could kill some slimes right now...
DIALOGDATA_SANCTUMCIVILIAN_00_LOCAL_BRANCH_MAP_HUB_SANCTUM__CLIENTNPCS__NPC_SANCTUMCIVILIAN_RED_04__DIALOGTRIGGER_DIALOG_0_INPUT	
DIALOGDATA_SANCTUMCIVILIAN_00_LOCAL_BRANCH_MAP_HUB_SANCTUM__CLIENTNPCS__NPC_SANCTUMCIVILIAN_RED_04__DIALOGTRIGGER_DIALOG_0_INPUT_ALT_0	It's dangerous out there. I'd advise you to be prepared.
DIALOGDATA_SANCTUMCIVILIAN_00_LOCAL_BRANCH_MAP_HUB_SANCTUM__CLIENTNPCS__NPC_SANCTUMCIVILIAN_RED_04__DIALOGTRIGGER_DIALOG_0_INPUT_ALT_1	In case if you don't know, the portal to the outer sanctum opens when you have spoken to Angela.
DIALOGDATA_SANCTUMCIVILIAN_00_LOCAL_BRANCH_MAP_HUB_SANCTUM__CLIENTNPCS__NPC_SANCTUMCIVILIAN_RED_04__DIALOGTRIGGER_DIALOG_0_INPUT_ALT_2	If only the outside world was safe like it once was...
DIALOGDATA_SANCTUMCIVILIAN_00_LOCAL_BRANCH_MAP_HUB_SANCTUM__CLIENTNPCS__NPC_SANCTUMCIVILIAN_RED_01__DIALOGTRIGGER_DIALOG_0_INPUT	
DIALOGDATA_SANCTUMCIVILIAN_00_LOCAL_BRANCH_MAP_HUB_SANCTUM__CLIENTNPCS__NPC_SANCTUMCIVILIAN_RED_01__DIALOGTRIGGER_DIALOG_0_INPUT_ALT_0	We try to keep Sanctum stocked with all the essentials.
DIALOGDATA_SANCTUMCIVILIAN_00_LOCAL_BRANCH_MAP_HUB_SANCTUM__CLIENTNPCS__NPC_SANCTUMCIVILIAN_RED_01__DIALOGTRIGGER_DIALOG_0_INPUT_ALT_1	How many bunbags do we have left? I lost count...
DIALOGDATA_SANCTUMCIVILIAN_00_LOCAL_BRANCH_MAP_HUB_SANCTUM__CLIENTNPCS__NPC_SANCTUMCIVILIAN_RED_01__DIALOGTRIGGER_DIALOG_0_INPUT_ALT_2	Hmm... I should talk to Sally just to make sure we have everything...
DIALOGDATA_SANCTUMCIVILIAN_00_LOCAL_BRANCH_MAP_HUB_SANCTUM__CLIENTNPCS__NPC_SANCTUMCIVILIAN_RED_01__DIALOGTRIGGER_DIALOG_0_INPUT_ALT_3	Agh, we seem to be low on carrot cake. I love that stuff!
DIALOGDATA_SANCTUMCIVILIAN_00_LOCAL_BRANCH_MAP_HUB_SANCTUM__CLIENTNPCS__NPC_SANCTUMCIVILIAN_RED_03__DIALOGTRIGGER_DIALOG_0_INPUT	
DIALOGDATA_SANCTUMCIVILIAN_00_LOCAL_BRANCH_MAP_HUB_SANCTUM__CLIENTNPCS__NPC_SANCTUMCIVILIAN_RED_03__DIALOGTRIGGER_DIALOG_0_INPUT_ALT_0	Hiya, traveller!
DIALOGDATA_SANCTUMCIVILIAN_00_LOCAL_BRANCH_MAP_HUB_SANCTUM__CLIENTNPCS__NPC_SANCTUMCIVILIAN_RED_03__DIALOGTRIGGER_DIALOG_0_INPUT_ALT_1	I've got some training to do, I wanna beat up some slimes!
DIALOGDATA_SANCTUMCIVILIAN_00_LOCAL_BRANCH_MAP_HUB_SANCTUM__CLIENTNPCS__NPC_SANCTUMCIVILIAN_RED_03__DIALOGTRIGGER_DIALOG_0_INPUT_ALT_2	We're not strong enough to take on the world outside, but I wanna prove that wrong someday.
DIALOGDATA_SANCTUMCIVILIAN_00_LOCAL_BRANCH_MAP_HUB_SANCTUM__CLIENTNPCS__NPC_SANCTUMCIVILIAN_RED_03__DIALOGTRIGGER_DIALOG_0_INPUT_ALT_3	Between you and me, I can't wait to kick this guys ass!
DIALOGDATA_SANCTUMCIVILIAN_00_LOCAL_BRANCH_MAP_HUB_SANCTUM__CLIENTNPCS__NPC_SANCTUMCIVILIAN_RED_03__DIALOGTRIGGER_DIALOG_0_INPUT_ALT_4	What? You've lived in a world that isn't always overcast?
DIALOGDATA_SANCTUMCIVILIAN_00_LOCAL_BRANCH_MAP_HUB_SANCTUM__CLIENTNPCS__NPC_SANCTUMCIVILIAN_RED_06__DIALOGTRIGGER_DIALOG_0_INPUT	
DIALOGDATA_SANCTUMCIVILIAN_00_LOCAL_BRANCH_MAP_HUB_SANCTUM__CLIENTNPCS__NPC_SANCTUMCIVILIAN_RED_06__DIALOGTRIGGER_DIALOG_0_INPUT_ALT_0	Hail, adventurer. This is the gateway to the Outer Sanctum.
DIALOGDATA_SANCTUMCIVILIAN_00_LOCAL_BRANCH_MAP_HUB_SANCTUM__CLIENTNPCS__NPC_SANCTUMCIVILIAN_RED_06__DIALOGTRIGGER_DIALOG_0_INPUT_ALT_1	I'm stationed here to guard Sanctum in case anything comes through.
DIALOGDATA_SANCTUMCIVILIAN_00_LOCAL_BRANCH_MAP_HUB_SANCTUM__CLIENTNPCS__NPC_SANCTUMCIVILIAN_RED_06__DIALOGTRIGGER_DIALOG_0_INPUT_ALT_2	Hm... how many chances have you had to prove yourself beyond this world?
DIALOGDATA_SANCTUMCIVILIAN_00_LOCAL_BRANCH_MAP_HUB_SANCTUM__CLIENTNPCS__NPC_SANCTUMCIVILIAN_GRN_01__DIALOGTRIGGER_DIALOG_0_INPUT	
DIALOGDATA_SANCTUMCIVILIAN_00_LOCAL_BRANCH_MAP_HUB_SANCTUM__CLIENTNPCS__NPC_SANCTUMCIVILIAN_GRN_01__DIALOGTRIGGER_DIALOG_0_INPUT_ALT_0	I do wonder what other place out there in this world is as safe as here...
DIALOGDATA_SANCTUMCIVILIAN_00_LOCAL_BRANCH_MAP_HUB_SANCTUM__CLIENTNPCS__NPC_SANCTUMCIVILIAN_GRN_01__DIALOGTRIGGER_DIALOG_0_INPUT_ALT_1	Have you been to the Crescent Keep? Rumor has it that it was once a temple of nature magic.
DIALOGDATA_SANCTUMCIVILIAN_00_LOCAL_BRANCH_MAP_HUB_SANCTUM__CLIENTNPCS__NPC_SANCTUMCIVILIAN_GRN_01__DIALOGTRIGGER_DIALOG_0_INPUT_ALT_2	The Guardians seem to have predated our existance, but i've been told this isn't true.
DIALOGDATA_SANCTUMCIVILIAN_00_LOCAL_BRANCH_MAP_HUB_SANCTUM__CLIENTNPCS__NPC_SANCTUMCIVILIAN_GRN_01__DIALOGTRIGGER_DIALOG_0_INPUT_ALT_3	I wonder what's for dinner...
DIALOGDATA_SANCTUMCIVILIAN_00_LOCAL_BRANCH_MAP_HUB_WALLOFTHESTARS__LOCALNPC__NPC_SANCTUMCIVILIAN_BLU__DIALOGTRIGGER_DIALOG_0_INPUT	
DIALOGDATA_SANCTUMCIVILIAN_00_LOCAL_BRANCH_MAP_HUB_WALLOFTHESTARS__LOCALNPC__NPC_SANCTUMCIVILIAN_BLU__DIALOGTRIGGER_DIALOG_0_INPUT_ALT_0	It's too lovely here for me to leave. I'll be staying here.
DIALOGDATA_SANCTUMCIVILIAN_00_LOCAL_BRANCH_MAP_HUB_WALLOFTHESTARS__LOCALNPC__NPC_SANCTUMCIVILIAN_BLU__DIALOGTRIGGER_DIALOG_0_INPUT_ALT_1	Did you open the portal leading here?
DIALOGDATA_SANCTUMCIVILIAN_00_LOCAL_BRANCH_MAP_HUB_WALLOFTHESTARS__LOCALNPC__NPC_SANCTUMCIVILIAN_BLU__DIALOGTRIGGER_DIALOG_0_INPUT_ALT_2	Blessed day, Angela has not forgotten us!
DIALOGDATA_SANCTUMCIVILIAN_00_LOCAL_BRANCH_MAP_HUB_WALLOFTHESTARS__LOCALNPC__NPC_SANCTUMCIVILIAN_RED_04__DIALOGTRIGGER_DIALOG_0_INPUT	
DIALOGDATA_SANCTUMCIVILIAN_00_LOCAL_BRANCH_MAP_HUB_WALLOFTHESTARS__LOCALNPC__NPC_SANCTUMCIVILIAN_RED_04__DIALOGTRIGGER_DIALOG_0_INPUT_ALT_0	Oh? I thought i'd never see anyone new here.
DIALOGDATA_SANCTUMCIVILIAN_00_LOCAL_BRANCH_MAP_HUB_WALLOFTHESTARS__LOCALNPC__NPC_SANCTUMCIVILIAN_RED_04__DIALOGTRIGGER_DIALOG_0_INPUT_ALT_1	It seems the portal is opened here now... thank goodness!
DIALOGDATA_SANCTUMCIVILIAN_00_LOCAL_BRANCH_MAP_HUB_WALLOFTHESTARS__LOCALNPC__NPC_SANCTUMCIVILIAN_RED_04__DIALOGTRIGGER_DIALOG_0_INPUT_ALT_2	Please rest here before going back out, and be careful!
DIALOGDATA_SANCTUMCIVILIAN_00_LOCAL_BRANCH_MAP_HUB_WALLOFTHESTARS__LOCALNPC__NPC_SANCTUMCIVILIAN_RED_04__DIALOGTRIGGER_DIALOG_0_INPUT_ALT_3	How is Sanctum? I hope things are okay there.
DIALOGDATA_SANCTUMCIVILIAN_00_LOCAL_BRANCH_MAP_HUB_WALLOFTHESTARS__LOCALNPC__NPC_SANCTUMCIVILIAN_GRN__DIALOGTRIGGER_DIALOG_0_INPUT	
DIALOGDATA_SANCTUMCIVILIAN_00_LOCAL_BRANCH_MAP_HUB_WALLOFTHESTARS__LOCALNPC__NPC_SANCTUMCIVILIAN_GRN__DIALOGTRIGGER_DIALOG_0_INPUT_ALT_0	Some say the Wall of the Stars can speak within your mind.
DIALOGDATA_SANCTUMCIVILIAN_00_LOCAL_BRANCH_MAP_HUB_WALLOFTHESTARS__LOCALNPC__NPC_SANCTUMCIVILIAN_GRN__DIALOGTRIGGER_DIALOG_0_INPUT_ALT_1	It's good to know we're not stranded here anymore...
DIALOGDATA_SANCTUMCIVILIAN_00_LOCAL_BRANCH_MAP_HUB_WALLOFTHESTARS__LOCALNPC__NPC_SANCTUMCIVILIAN_GRN__DIALOGTRIGGER_DIALOG_0_INPUT_ALT_2	We're so fortunate to have been stuck here rather than somewhere dangerous...
DIALOGDATA_SANCTUMCIVILIAN_00_LOCAL_BRANCH_MAP_HUB_WALLOFTHESTARS__LOCALNPC__NPC_SANCTUMCIVILIAN_GRN__DIALOGTRIGGER_DIALOG_0_INPUT_ALT_3	Hello, traveler.